"","Date","num_day","num_ind","num_dir","percent_ind"
"1","1/1/1994",62,4,58,6.89655172413793
"2","1/1/1995",122,0,122,0
"3","1/1/1996",67,0,67,0
"4","1/1/1997",70,1,69,1.44927536231884
"5","1/1/1998",66,2,64,3.125
"6","1/1/1999",63,4,59,6.77966101694915
"7","1/1/2000",62,3,59,5.08474576271187
"8","1/1/2001",75,5,70,7.14285714285714
"9","1/1/2002",68,4,64,6.25
"10","1/1/2003",71,4,67,5.97014925373134
"11","1/1/2004",65,1,64,1.5625
"12","1/1/2005",42,1,41,2.4390243902439
"13","1/1/2006",123,4,119,3.36134453781513
"14","1/1/2007",78,0,78,0
"15","1/1/2008",76,0,76,0
"16","1/1/2009",68,4,64,6.25
"17","1/1/2010",64,3,61,4.91803278688525
"18","1/1/2011",56,2,54,3.7037037037037
"19","1/1/2012",125,3,122,2.45901639344262
"20","1/1/2013",72,1,71,1.40845070422535
"21","1/1/2014",67,2,65,3.07692307692308
"22","1/1/2015",68,7,61,11.4754098360656
"23","1/1/2016",59,5,54,9.25925925925926
"24","1/1/2017",137,5,132,3.78787878787879
"25","1/1/2018",70,1,69,1.44927536231884
"26","1/1/2019",74,0,74,0
"27","1/1/2020",68,1,67,1.49253731343284
"28","1/1/2021",68,4,64,6.25
"29","1/10/1994",65,1,64,1.5625
"30","1/10/1995",66,0,66,0
"31","1/10/1996",70,2,68,2.94117647058824
"32","1/10/1997",65,0,65,0
"33","1/10/1998",58,0,58,0
"34","1/10/1999",126,5,121,4.13223140495868
"35","1/10/2000",77,1,76,1.31578947368421
"36","1/10/2001",73,0,73,0
"37","1/10/2002",70,3,67,4.47761194029851
"38","1/10/2003",53,1,52,1.92307692307692
"39","1/10/2004",57,1,56,1.78571428571429
"40","1/10/2005",75,0,75,0
"41","1/10/2006",73,1,72,1.38888888888889
"42","1/10/2007",74,2,72,2.77777777777778
"43","1/10/2008",70,4,66,6.06060606060606
"44","1/10/2009",61,1,60,1.66666666666667
"45","1/10/2010",133,3,130,2.30769230769231
"46","1/10/2011",74,1,73,1.36986301369863
"47","1/10/2012",72,0,72,0
"48","1/10/2013",74,2,72,2.77777777777778
"49","1/10/2014",55,5,50,10
"50","1/10/2015",55,7,48,14.5833333333333
"51","1/10/2016",133,2,131,1.52671755725191
"52","1/10/2017",76,0,76,0
"53","1/10/2018",71,9,62,14.5161290322581
"54","1/10/2019",71,4,67,5.97014925373134
"55","1/10/2020",63,2,61,3.27868852459016
"56","1/10/2021",124,6,118,5.08474576271187
"57","1/11/1994",76,2,74,2.7027027027027
"58","1/11/1995",68,1,67,1.49253731343284
"59","1/11/1996",70,2,68,2.94117647058824
"60","1/11/1997",63,1,62,1.61290322580645
"61","1/11/1998",128,3,125,2.4
"62","1/11/1999",75,1,74,1.35135135135135
"63","1/11/2000",74,4,70,5.71428571428571
"64","1/11/2001",65,1,64,1.5625
"65","1/11/2002",56,1,55,1.81818181818182
"66","1/11/2003",68,3,65,4.61538461538462
"67","1/11/2004",124,1,123,0.813008130081301
"68","1/11/2005",72,2,70,2.85714285714286
"69","1/11/2006",66,2,64,3.125
"70","1/11/2007",66,2,64,3.125
"71","1/11/2008",65,4,61,6.55737704918033
"72","1/11/2009",124,5,119,4.20168067226891
"73","1/11/2010",71,0,71,0
"74","1/11/2011",71,1,70,1.42857142857143
"75","1/11/2012",70,3,67,4.47761194029851
"76","1/11/2013",63,3,60,5
"77","1/11/2014",54,4,50,8
"78","1/11/2015",127,9,118,7.6271186440678
"79","1/11/2016",77,4,73,5.47945205479452
"80","1/11/2017",72,2,70,2.85714285714286
"81","1/11/2018",65,6,59,10.1694915254237
"82","1/11/2019",66,2,64,3.125
"83","1/11/2020",64,5,59,8.47457627118644
"84","1/11/2021",73,4,69,5.79710144927536
"85","1/12/1994",78,5,73,6.84931506849315
"86","1/12/1995",68,2,66,3.03030303030303
"87","1/12/1996",64,0,64,0
"88","1/12/1997",155,2,153,1.30718954248366
"89","1/12/1998",74,5,69,7.2463768115942
"90","1/12/1999",75,5,70,7.14285714285714
"91","1/12/2000",73,3,70,4.28571428571429
"92","1/12/2001",61,3,58,5.17241379310345
"93","1/12/2002",63,2,61,3.27868852459016
"94","1/12/2003",131,5,126,3.96825396825397
"95","1/12/2004",76,1,75,1.33333333333333
"96","1/12/2005",73,2,71,2.8169014084507
"97","1/12/2006",76,1,75,1.33333333333333
"98","1/12/2007",59,2,57,3.50877192982456
"99","1/12/2008",62,4,58,6.89655172413793
"100","1/12/2009",72,1,71,1.40845070422535
"101","1/12/2010",73,5,68,7.35294117647059
"102","1/12/2011",68,1,67,1.49253731343284
"103","1/12/2012",75,0,75,0
"104","1/12/2013",64,5,59,8.47457627118644
"105","1/12/2014",129,4,125,3.2
"106","1/12/2015",74,0,74,0
"107","1/12/2016",78,2,76,2.63157894736842
"108","1/12/2017",68,3,65,4.61538461538462
"109","1/12/2018",50,1,49,2.04081632653061
"110","1/12/2019",52,3,49,6.12244897959184
"111","1/12/2020",129,2,127,1.5748031496063
"112","1/12/2021",68,2,66,3.03030303030303
"113","1/13/1994",74,4,70,5.71428571428571
"114","1/13/1995",73,1,72,1.38888888888889
"115","1/13/1996",57,0,57,0
"116","1/13/1997",76,0,76,0
"117","1/13/1998",75,0,75,0
"118","1/13/1999",71,1,70,1.42857142857143
"119","1/13/2000",68,3,65,4.61538461538462
"120","1/13/2001",66,0,66,0
"121","1/13/2002",126,1,125,0.8
"122","1/13/2003",73,1,72,1.38888888888889
"123","1/13/2004",67,0,67,0
"124","1/13/2005",74,2,72,2.77777777777778
"125","1/13/2006",59,1,58,1.72413793103448
"126","1/13/2007",57,1,56,1.78571428571429
"127","1/13/2008",122,4,118,3.38983050847458
"128","1/13/2009",77,0,77,0
"129","1/13/2010",73,2,71,2.8169014084507
"130","1/13/2011",67,0,67,0
"131","1/13/2012",60,5,55,9.09090909090909
"132","1/13/2013",121,6,115,5.21739130434783
"133","1/13/2014",70,0,70,0
"134","1/13/2015",74,1,73,1.36986301369863
"135","1/13/2016",69,4,65,6.15384615384615
"136","1/13/2017",65,2,63,3.17460317460317
"137","1/13/2018",61,0,61,0
"138","1/13/2019",123,1,122,0.819672131147541
"139","1/13/2020",70,1,69,1.44927536231884
"140","1/13/2021",68,9,59,15.2542372881356
"141","1/14/1994",62,2,60,3.33333333333333
"142","1/14/1995",68,0,68,0
"143","1/14/1996",126,3,123,2.4390243902439
"144","1/14/1997",74,0,74,0
"145","1/14/1998",71,1,70,1.42857142857143
"146","1/14/1999",71,2,69,2.89855072463768
"147","1/14/2000",64,0,64,0
"148","1/14/2001",128,4,124,3.2258064516129
"149","1/14/2002",72,2,70,2.85714285714286
"150","1/14/2003",76,3,73,4.10958904109589
"151","1/14/2004",72,2,70,2.85714285714286
"152","1/14/2005",59,1,58,1.72413793103448
"153","1/14/2006",64,4,60,6.66666666666667
"154","1/14/2007",131,1,130,0.769230769230769
"155","1/14/2008",74,0,74,0
"156","1/14/2009",65,0,65,0
"157","1/14/2010",68,4,64,6.25
"158","1/14/2011",64,4,60,6.66666666666667
"159","1/14/2012",42,6,36,16.6666666666667
"160","1/14/2013",72,1,71,1.40845070422535
"161","1/14/2014",80,1,79,1.26582278481013
"162","1/14/2015",74,4,70,5.71428571428571
"163","1/14/2016",64,2,62,3.2258064516129
"164","1/14/2017",63,3,60,5
"165","1/14/2018",130,6,124,4.83870967741935
"166","1/14/2019",72,1,71,1.40845070422535
"167","1/14/2020",74,1,73,1.36986301369863
"168","1/14/2021",76,4,72,5.55555555555556
"169","1/15/1994",62,4,58,6.89655172413793
"170","1/15/1995",125,1,124,0.806451612903226
"171","1/15/1996",73,0,73,0
"172","1/15/1997",74,2,72,2.77777777777778
"173","1/15/1998",71,0,71,0
"174","1/15/1999",63,1,62,1.61290322580645
"175","1/15/2000",59,6,53,11.3207547169811
"176","1/15/2001",75,0,75,0
"177","1/15/2002",70,4,66,6.06060606060606
"178","1/15/2003",75,3,72,4.16666666666667
"179","1/15/2004",72,2,70,2.85714285714286
"180","1/15/2005",57,3,54,5.55555555555556
"181","1/15/2006",130,7,123,5.69105691056911
"182","1/15/2007",77,1,76,1.31578947368421
"183","1/15/2008",75,0,75,0
"184","1/15/2009",68,5,63,7.93650793650794
"185","1/15/2010",50,3,47,6.38297872340426
"186","1/15/2011",57,2,55,3.63636363636364
"187","1/15/2012",128,3,125,2.4
"188","1/15/2013",70,0,70,0
"189","1/15/2014",69,0,69,0
"190","1/15/2015",68,4,64,6.25
"191","1/15/2016",59,6,53,11.3207547169811
"192","1/15/2017",124,4,120,3.33333333333333
"193","1/15/2018",71,3,68,4.41176470588235
"194","1/15/2019",64,3,61,4.91803278688525
"195","1/15/2020",76,1,75,1.33333333333333
"196","1/15/2021",61,6,55,10.9090909090909
"197","1/16/1994",127,2,125,1.6
"198","1/16/1995",72,1,71,1.40845070422535
"199","1/16/1996",73,1,72,1.38888888888889
"200","1/16/1997",69,2,67,2.98507462686567
"201","1/16/1998",62,3,59,5.08474576271187
"202","1/16/1999",66,2,64,3.125
"203","1/16/2000",126,3,123,2.4390243902439
"204","1/16/2001",79,0,79,0
"205","1/16/2002",72,0,72,0
"206","1/16/2003",73,2,71,2.8169014084507
"207","1/16/2004",62,3,59,5.08474576271187
"208","1/16/2005",123,1,122,0.819672131147541
"209","1/16/2006",71,0,71,0
"210","1/16/2007",73,2,71,2.8169014084507
"211","1/16/2008",69,3,66,4.54545454545455
"212","1/16/2009",62,4,58,6.89655172413793
"213","1/16/2010",60,4,56,7.14285714285714
"214","1/16/2011",125,7,118,5.93220338983051
"215","1/16/2012",73,0,73,0
"216","1/16/2013",74,1,73,1.36986301369863
"217","1/16/2014",73,4,69,5.79710144927536
"218","1/16/2015",61,4,57,7.01754385964912
"219","1/16/2016",62,7,55,12.7272727272727
"220","1/16/2017",72,0,72,0
"221","1/16/2018",75,2,73,2.73972602739726
"222","1/16/2019",67,0,67,0
"223","1/16/2020",73,4,69,5.79710144927536
"224","1/16/2021",51,4,47,8.51063829787234
"225","1/17/1994",70,5,65,7.69230769230769
"226","1/17/1995",75,0,75,0
"227","1/17/1996",71,1,70,1.42857142857143
"228","1/17/1997",58,4,54,7.40740740740741
"229","1/17/1998",66,5,61,8.19672131147541
"230","1/17/1999",134,7,127,5.51181102362205
"231","1/17/2000",72,0,72,0
"232","1/17/2001",73,2,71,2.8169014084507
"233","1/17/2002",67,5,62,8.06451612903226
"234","1/17/2003",60,0,60,0
"235","1/17/2004",57,2,55,3.63636363636364
"236","1/17/2005",74,0,74,0
"237","1/17/2006",71,0,71,0
"238","1/17/2007",72,4,68,5.88235294117647
"239","1/17/2008",76,2,74,2.7027027027027
"240","1/17/2009",63,1,62,1.61290322580645
"241","1/17/2010",130,2,128,1.5625
"242","1/17/2011",65,0,65,0
"243","1/17/2012",77,0,77,0
"244","1/17/2013",62,5,57,8.7719298245614
"245","1/17/2014",53,6,47,12.7659574468085
"246","1/17/2015",59,3,56,5.35714285714286
"247","1/17/2016",121,3,118,2.54237288135593
"248","1/17/2017",69,3,66,4.54545454545455
"249","1/17/2018",76,2,74,2.7027027027027
"250","1/17/2019",69,2,67,2.98507462686567
"251","1/17/2020",61,2,59,3.38983050847458
"252","1/17/2021",130,6,124,4.83870967741935
"253","1/18/1994",71,1,70,1.42857142857143
"254","1/18/1995",72,0,72,0
"255","1/18/1996",65,0,65,0
"256","1/18/1997",63,0,63,0
"257","1/18/1998",149,8,141,5.67375886524823
"258","1/18/1999",73,1,72,1.38888888888889
"259","1/18/2000",69,3,66,4.54545454545455
"260","1/18/2001",67,2,65,3.07692307692308
"261","1/18/2002",62,6,56,10.7142857142857
"262","1/18/2003",67,2,65,3.07692307692308
"263","1/18/2004",126,2,124,1.61290322580645
"264","1/18/2005",76,0,76,0
"265","1/18/2006",70,2,68,2.94117647058824
"266","1/18/2007",65,0,65,0
"267","1/18/2008",60,3,57,5.26315789473684
"268","1/18/2009",128,3,125,2.4
"269","1/18/2010",72,0,72,0
"270","1/18/2011",76,0,76,0
"271","1/18/2012",74,2,72,2.77777777777778
"272","1/18/2013",63,7,56,12.5
"273","1/18/2014",63,6,57,10.5263157894737
"274","1/18/2015",128,3,125,2.4
"275","1/18/2016",70,0,70,0
"276","1/18/2017",71,1,70,1.42857142857143
"277","1/18/2018",67,4,63,6.34920634920635
"278","1/18/2019",64,7,57,12.280701754386
"279","1/18/2020",54,2,52,3.84615384615385
"280","1/18/2021",73,0,73,0
"281","1/19/1994",71,1,70,1.42857142857143
"282","1/19/1995",70,1,69,1.44927536231884
"283","1/19/1996",63,0,63,0
"284","1/19/1997",127,8,119,6.72268907563025
"285","1/19/1998",77,0,77,0
"286","1/19/1999",70,0,70,0
"287","1/19/2000",77,1,76,1.31578947368421
"288","1/19/2001",46,2,44,4.54545454545455
"289","1/19/2002",62,6,56,10.7142857142857
"290","1/19/2003",126,4,122,3.27868852459016
"291","1/19/2004",73,2,71,2.8169014084507
"292","1/19/2005",68,3,65,4.61538461538462
"293","1/19/2006",66,2,64,3.125
"294","1/19/2007",63,1,62,1.61290322580645
"295","1/19/2008",59,6,53,11.3207547169811
"296","1/19/2009",74,1,73,1.36986301369863
"297","1/19/2010",73,0,73,0
"298","1/19/2011",72,1,71,1.40845070422535
"299","1/19/2012",67,2,65,3.07692307692308
"300","1/19/2013",64,3,61,4.91803278688525
"301","1/19/2014",127,3,124,2.41935483870968
"302","1/19/2015",75,1,74,1.35135135135135
"303","1/19/2016",61,2,59,3.38983050847458
"304","1/19/2017",63,2,61,3.27868852459016
"305","1/19/2018",65,5,60,8.33333333333333
"306","1/19/2019",59,4,55,7.27272727272727
"307","1/19/2020",127,3,124,2.41935483870968
"308","1/19/2021",74,3,71,4.22535211267606
"309","1/2/1994",154,13,141,9.21985815602837
"310","1/2/1995",76,0,76,0
"311","1/2/1996",76,0,76,0
"312","1/2/1997",69,1,68,1.47058823529412
"313","1/2/1998",63,1,62,1.61290322580645
"314","1/2/1999",64,4,60,6.66666666666667
"315","1/2/2000",126,3,123,2.4390243902439
"316","1/2/2001",75,0,75,0
"317","1/2/2002",74,1,73,1.36986301369863
"318","1/2/2003",72,3,69,4.34782608695652
"319","1/2/2004",64,3,61,4.91803278688525
"320","1/2/2005",130,2,128,1.5625
"321","1/2/2006",67,0,67,0
"322","1/2/2007",72,2,70,2.85714285714286
"323","1/2/2008",75,2,73,2.73972602739726
"324","1/2/2009",66,6,60,10
"325","1/2/2010",44,3,41,7.31707317073171
"326","1/2/2011",131,7,124,5.64516129032258
"327","1/2/2012",74,0,74,0
"328","1/2/2013",76,3,73,4.10958904109589
"329","1/2/2014",65,1,64,1.5625
"330","1/2/2015",59,7,52,13.4615384615385
"331","1/2/2016",65,5,60,8.33333333333333
"332","1/2/2017",72,0,72,0
"333","1/2/2018",72,1,71,1.40845070422535
"334","1/2/2019",71,2,69,2.89855072463768
"335","1/2/2020",72,1,71,1.40845070422535
"336","1/2/2021",61,6,55,10.9090909090909
"337","1/20/1994",68,2,66,3.03030303030303
"338","1/20/1995",63,2,61,3.27868852459016
"339","1/20/1996",56,0,56,0
"340","1/20/1997",77,0,77,0
"341","1/20/1998",73,0,73,0
"342","1/20/1999",73,1,72,1.38888888888889
"343","1/20/2000",72,3,69,4.34782608695652
"344","1/20/2001",58,8,50,16
"345","1/20/2002",126,8,118,6.77966101694915
"346","1/20/2003",69,2,67,2.98507462686567
"347","1/20/2004",74,0,74,0
"348","1/20/2005",73,2,71,2.8169014084507
"349","1/20/2006",66,3,63,4.76190476190476
"350","1/20/2007",48,2,46,4.34782608695652
"351","1/20/2008",121,4,117,3.41880341880342
"352","1/20/2009",69,1,68,1.47058823529412
"353","1/20/2010",70,2,68,2.94117647058824
"354","1/20/2011",65,4,61,6.55737704918033
"355","1/20/2012",55,2,53,3.77358490566038
"356","1/20/2013",126,2,124,1.61290322580645
"357","1/20/2014",74,1,73,1.36986301369863
"358","1/20/2015",76,1,75,1.33333333333333
"359","1/20/2016",68,2,66,3.03030303030303
"360","1/20/2017",65,1,64,1.5625
"361","1/20/2018",50,5,45,11.1111111111111
"362","1/20/2019",124,3,121,2.47933884297521
"363","1/20/2020",70,0,70,0
"364","1/20/2021",72,3,69,4.34782608695652
"365","1/21/1994",61,1,60,1.66666666666667
"366","1/21/1995",58,2,56,3.57142857142857
"367","1/21/1996",124,1,123,0.813008130081301
"368","1/21/1997",74,0,74,0
"369","1/21/1998",76,0,76,0
"370","1/21/1999",67,2,65,3.07692307692308
"371","1/21/2000",62,1,61,1.63934426229508
"372","1/21/2001",128,10,118,8.47457627118644
"373","1/21/2002",75,3,72,4.16666666666667
"374","1/21/2003",73,1,72,1.38888888888889
"375","1/21/2004",74,1,73,1.36986301369863
"376","1/21/2005",28,0,28,0
"377","1/21/2006",47,2,45,4.44444444444444
"378","1/21/2007",119,3,116,2.58620689655172
"379","1/21/2008",76,1,75,1.33333333333333
"380","1/21/2009",74,4,70,5.71428571428571
"381","1/21/2010",63,2,61,3.27868852459016
"382","1/21/2011",64,4,60,6.66666666666667
"383","1/21/2012",64,8,56,14.2857142857143
"384","1/21/2013",73,1,72,1.38888888888889
"385","1/21/2014",78,0,78,0
"386","1/21/2015",76,1,75,1.33333333333333
"387","1/21/2016",76,1,75,1.33333333333333
"388","1/21/2017",65,2,63,3.17460317460317
"389","1/21/2018",118,4,114,3.50877192982456
"390","1/21/2019",74,0,74,0
"391","1/21/2020",75,2,73,2.73972602739726
"392","1/21/2021",72,3,69,4.34782608695652
"393","1/22/1994",70,2,68,2.94117647058824
"394","1/22/1995",118,1,117,0.854700854700855
"395","1/22/1996",72,0,72,0
"396","1/22/1997",71,0,71,0
"397","1/22/1998",73,0,73,0
"398","1/22/1999",68,1,67,1.49253731343284
"399","1/22/2000",55,2,53,3.77358490566038
"400","1/22/2001",75,4,71,5.63380281690141
"401","1/22/2002",76,0,76,0
"402","1/22/2003",69,1,68,1.47058823529412
"403","1/22/2004",72,0,72,0
"404","1/22/2005",48,6,42,14.2857142857143
"405","1/22/2006",130,4,126,3.17460317460317
"406","1/22/2007",73,2,71,2.8169014084507
"407","1/22/2008",79,3,76,3.94736842105263
"408","1/22/2009",71,3,68,4.41176470588235
"409","1/22/2010",66,6,60,10
"410","1/22/2011",64,6,58,10.3448275862069
"411","1/22/2012",116,4,112,3.57142857142857
"412","1/22/2013",72,3,69,4.34782608695652
"413","1/22/2014",66,2,64,3.125
"414","1/22/2015",71,6,65,9.23076923076923
"415","1/22/2016",60,3,57,5.26315789473684
"416","1/22/2017",122,9,113,7.9646017699115
"417","1/22/2018",74,1,73,1.36986301369863
"418","1/22/2019",73,2,71,2.8169014084507
"419","1/22/2020",77,3,74,4.05405405405405
"420","1/22/2021",66,4,62,6.45161290322581
"421","1/23/1994",124,6,118,5.08474576271187
"422","1/23/1995",74,2,72,2.77777777777778
"423","1/23/1996",73,0,73,0
"424","1/23/1997",68,1,67,1.49253731343284
"425","1/23/1998",67,2,65,3.07692307692308
"426","1/23/1999",49,2,47,4.25531914893617
"427","1/23/2000",122,2,120,1.66666666666667
"428","1/23/2001",71,0,71,0
"429","1/23/2002",74,2,72,2.77777777777778
"430","1/23/2003",71,0,71,0
"431","1/23/2004",60,0,60,0
"432","1/23/2005",126,4,122,3.27868852459016
"433","1/23/2006",74,2,72,2.77777777777778
"434","1/23/2007",73,1,72,1.38888888888889
"435","1/23/2008",67,1,66,1.51515151515152
"436","1/23/2009",65,1,64,1.5625
"437","1/23/2010",62,5,57,8.7719298245614
"438","1/23/2011",138,8,130,6.15384615384615
"439","1/23/2012",76,0,76,0
"440","1/23/2013",68,6,62,9.67741935483871
"441","1/23/2014",73,1,72,1.38888888888889
"442","1/23/2015",66,10,56,17.8571428571429
"443","1/23/2016",56,3,53,5.66037735849057
"444","1/23/2017",69,1,68,1.47058823529412
"445","1/23/2018",75,2,73,2.73972602739726
"446","1/23/2019",72,1,71,1.40845070422535
"447","1/23/2020",70,2,68,2.94117647058824
"448","1/23/2021",59,2,57,3.50877192982456
"449","1/24/1994",70,0,70,0
"450","1/24/1995",77,0,77,0
"451","1/24/1996",70,0,70,0
"452","1/24/1997",62,0,62,0
"453","1/24/1998",53,2,51,3.92156862745098
"454","1/24/1999",128,3,125,2.4
"455","1/24/2000",75,0,75,0
"456","1/24/2001",69,4,65,6.15384615384615
"457","1/24/2002",69,3,66,4.54545454545455
"458","1/24/2003",61,4,57,7.01754385964912
"459","1/24/2004",53,1,52,1.92307692307692
"460","1/24/2005",73,2,71,2.8169014084507
"461","1/24/2006",74,0,74,0
"462","1/24/2007",70,1,69,1.44927536231884
"463","1/24/2008",69,4,65,6.15384615384615
"464","1/24/2009",59,1,58,1.72413793103448
"465","1/24/2010",155,3,152,1.97368421052632
"466","1/24/2011",73,0,73,0
"467","1/24/2012",77,2,75,2.66666666666667
"468","1/24/2013",70,0,70,0
"469","1/24/2014",63,6,57,10.5263157894737
"470","1/24/2015",49,7,42,16.6666666666667
"471","1/24/2016",118,5,113,4.42477876106195
"472","1/24/2017",70,1,69,1.44927536231884
"473","1/24/2018",68,2,66,3.03030303030303
"474","1/24/2019",77,4,73,5.47945205479452
"475","1/24/2020",63,6,57,10.5263157894737
"476","1/24/2021",128,7,121,5.78512396694215
"477","1/25/1994",67,4,63,6.34920634920635
"478","1/25/1995",74,1,73,1.36986301369863
"479","1/25/1996",67,0,67,0
"480","1/25/1997",66,2,64,3.125
"481","1/25/1998",122,1,121,0.826446280991736
"482","1/25/1999",72,1,71,1.40845070422535
"483","1/25/2000",64,2,62,3.2258064516129
"484","1/25/2001",65,5,60,8.33333333333333
"485","1/25/2002",62,6,56,10.7142857142857
"486","1/25/2003",59,4,55,7.27272727272727
"487","1/25/2004",130,1,129,0.775193798449612
"488","1/25/2005",74,0,74,0
"489","1/25/2006",79,3,76,3.94736842105263
"490","1/25/2007",73,3,70,4.28571428571429
"491","1/25/2008",66,2,64,3.125
"492","1/25/2009",117,1,116,0.862068965517241
"493","1/25/2010",75,0,75,0
"494","1/25/2011",74,2,72,2.77777777777778
"495","1/25/2012",71,0,71,0
"496","1/25/2013",61,6,55,10.9090909090909
"497","1/25/2014",65,6,59,10.1694915254237
"498","1/25/2015",124,13,111,11.7117117117117
"499","1/25/2016",73,1,72,1.38888888888889
"500","1/25/2017",71,0,71,0
"501","1/25/2018",66,4,62,6.45161290322581
"502","1/25/2019",66,3,63,4.76190476190476
"503","1/25/2020",64,3,61,4.91803278688525
"504","1/25/2021",74,3,71,4.22535211267606
"505","1/26/1994",69,0,69,0
"506","1/26/1995",64,2,62,3.2258064516129
"507","1/26/1996",57,3,54,5.55555555555556
"508","1/26/1997",121,3,118,2.54237288135593
"509","1/26/1998",75,0,75,0
"510","1/26/1999",76,0,76,0
"511","1/26/2000",69,2,67,2.98507462686567
"512","1/26/2001",65,3,62,4.83870967741935
"513","1/26/2002",54,2,52,3.84615384615385
"514","1/26/2003",129,3,126,2.38095238095238
"515","1/26/2004",74,1,73,1.36986301369863
"516","1/26/2005",71,0,71,0
"517","1/26/2006",65,3,62,4.83870967741935
"518","1/26/2007",63,2,61,3.27868852459016
"519","1/26/2008",60,3,57,5.26315789473684
"520","1/26/2009",72,0,72,0
"521","1/26/2010",74,2,72,2.77777777777778
"522","1/26/2011",72,2,70,2.85714285714286
"523","1/26/2012",66,4,62,6.45161290322581
"524","1/26/2013",48,5,43,11.6279069767442
"525","1/26/2014",129,4,125,3.2
"526","1/26/2015",74,1,73,1.36986301369863
"527","1/26/2016",74,3,71,4.22535211267606
"528","1/26/2017",70,4,66,6.06060606060606
"529","1/26/2018",59,5,54,9.25925925925926
"530","1/26/2019",57,2,55,3.63636363636364
"531","1/26/2020",125,3,122,2.45901639344262
"532","1/26/2021",69,2,67,2.98507462686567
"533","1/27/1994",72,4,68,5.88235294117647
"534","1/27/1995",63,0,63,0
"535","1/27/1996",66,0,66,0
"536","1/27/1997",75,0,75,0
"537","1/27/1998",73,1,72,1.38888888888889
"538","1/27/1999",69,2,67,2.98507462686567
"539","1/27/2000",68,0,68,0
"540","1/27/2001",67,4,63,6.34920634920635
"541","1/27/2002",127,8,119,6.72268907563025
"542","1/27/2003",72,0,72,0
"543","1/27/2004",75,0,75,0
"544","1/27/2005",68,2,66,3.03030303030303
"545","1/27/2006",59,5,54,9.25925925925926
"546","1/27/2007",60,3,57,5.26315789473684
"547","1/27/2008",151,0,151,0
"548","1/27/2009",70,0,70,0
"549","1/27/2010",72,5,67,7.46268656716418
"550","1/27/2011",71,4,67,5.97014925373134
"551","1/27/2012",68,7,61,11.4754098360656
"552","1/27/2013",114,14,100,14
"553","1/27/2014",76,1,75,1.33333333333333
"554","1/27/2015",75,3,72,4.16666666666667
"555","1/27/2016",75,0,75,0
"556","1/27/2017",61,6,55,10.9090909090909
"557","1/27/2018",55,5,50,10
"558","1/27/2019",120,2,118,1.69491525423729
"559","1/27/2020",73,1,72,1.38888888888889
"560","1/27/2021",75,3,72,4.16666666666667
"561","1/28/1994",62,3,59,5.08474576271187
"562","1/28/1995",49,1,48,2.08333333333333
"563","1/28/1996",130,0,130,0
"564","1/28/1997",74,1,73,1.36986301369863
"565","1/28/1998",73,2,71,2.8169014084507
"566","1/28/1999",67,2,65,3.07692307692308
"567","1/28/2000",62,2,60,3.33333333333333
"568","1/28/2001",123,6,117,5.12820512820513
"569","1/28/2002",76,1,75,1.33333333333333
"570","1/28/2003",72,2,70,2.85714285714286
"571","1/28/2004",66,3,63,4.76190476190476
"572","1/28/2005",63,3,60,5
"573","1/28/2006",61,1,60,1.66666666666667
"574","1/28/2007",125,2,123,1.6260162601626
"575","1/28/2008",73,0,73,0
"576","1/28/2009",72,4,68,5.88235294117647
"577","1/28/2010",59,2,57,3.50877192982456
"578","1/28/2011",63,6,57,10.5263157894737
"579","1/28/2012",67,4,63,6.34920634920635
"580","1/28/2013",69,0,69,0
"581","1/28/2014",74,2,72,2.77777777777778
"582","1/28/2015",70,1,69,1.44927536231884
"583","1/28/2016",74,4,70,5.71428571428571
"584","1/28/2017",62,3,59,5.08474576271187
"585","1/28/2018",128,7,121,5.78512396694215
"586","1/28/2019",69,1,68,1.47058823529412
"587","1/28/2020",68,1,67,1.49253731343284
"588","1/28/2021",70,2,68,2.94117647058824
"589","1/29/1994",59,3,56,5.35714285714286
"590","1/29/1995",132,0,132,0
"591","1/29/1996",70,0,70,0
"592","1/29/1997",71,0,71,0
"593","1/29/1998",71,1,70,1.42857142857143
"594","1/29/1999",64,2,62,3.2258064516129
"595","1/29/2000",62,4,58,6.89655172413793
"596","1/29/2001",73,0,73,0
"597","1/29/2002",72,0,72,0
"598","1/29/2003",72,2,70,2.85714285714286
"599","1/29/2004",66,4,62,6.45161290322581
"600","1/29/2005",55,1,54,1.85185185185185
"601","1/29/2006",124,3,121,2.47933884297521
"602","1/29/2007",74,0,74,0
"603","1/29/2008",72,1,71,1.40845070422535
"604","1/29/2009",70,3,67,4.47761194029851
"605","1/29/2010",64,8,56,14.2857142857143
"606","1/29/2011",59,5,54,9.25925925925926
"607","1/29/2012",128,5,123,4.0650406504065
"608","1/29/2013",72,1,71,1.40845070422535
"609","1/29/2014",74,0,74,0
"610","1/29/2015",73,5,68,7.35294117647059
"611","1/29/2016",61,4,57,7.01754385964912
"612","1/29/2017",123,4,119,3.36134453781513
"613","1/29/2018",73,0,73,0
"614","1/29/2019",73,1,72,1.38888888888889
"615","1/29/2020",68,5,63,7.93650793650794
"616","1/29/2021",65,4,61,6.55737704918033
"617","1/3/1994",73,1,72,1.38888888888889
"618","1/3/1995",73,0,73,0
"619","1/3/1996",74,0,74,0
"620","1/3/1997",58,3,55,5.45454545454545
"621","1/3/1998",68,3,65,4.61538461538462
"622","1/3/1999",131,2,129,1.55038759689922
"623","1/3/2000",73,1,72,1.38888888888889
"624","1/3/2001",71,2,69,2.89855072463768
"625","1/3/2002",68,1,67,1.49253731343284
"626","1/3/2003",64,6,58,10.3448275862069
"627","1/3/2004",70,7,63,11.1111111111111
"628","1/3/2005",74,0,74,0
"629","1/3/2006",75,5,70,7.14285714285714
"630","1/3/2007",72,3,69,4.34782608695652
"631","1/3/2008",75,7,68,10.2941176470588
"632","1/3/2009",59,1,58,1.72413793103448
"633","1/3/2010",123,5,118,4.23728813559322
"634","1/3/2011",76,0,76,0
"635","1/3/2012",69,2,67,2.98507462686567
"636","1/3/2013",61,0,61,0
"637","1/3/2014",60,0,60,0
"638","1/3/2015",64,11,53,20.7547169811321
"639","1/3/2016",127,8,119,6.72268907563025
"640","1/3/2017",67,2,65,3.07692307692308
"641","1/3/2018",71,1,70,1.42857142857143
"642","1/3/2019",64,7,57,12.280701754386
"643","1/3/2020",64,4,60,6.66666666666667
"644","1/3/2021",125,4,121,3.30578512396694
"645","1/30/1994",149,5,144,3.47222222222222
"646","1/30/1995",68,0,68,0
"647","1/30/1996",72,1,71,1.40845070422535
"648","1/30/1997",69,0,69,0
"649","1/30/1998",61,2,59,3.38983050847458
"650","1/30/1999",57,3,54,5.55555555555556
"651","1/30/2000",130,3,127,2.36220472440945
"652","1/30/2001",71,1,70,1.42857142857143
"653","1/30/2002",75,2,73,2.73972602739726
"654","1/30/2003",67,2,65,3.07692307692308
"655","1/30/2004",67,2,65,3.07692307692308
"656","1/30/2005",120,1,119,0.840336134453782
"657","1/30/2006",72,0,72,0
"658","1/30/2007",71,2,69,2.89855072463768
"659","1/30/2008",68,0,68,0
"660","1/30/2009",62,0,62,0
"661","1/30/2010",53,0,53,0
"662","1/30/2011",146,8,138,5.79710144927536
"663","1/30/2012",74,0,74,0
"664","1/30/2013",69,1,68,1.47058823529412
"665","1/30/2014",71,5,66,7.57575757575758
"666","1/30/2015",58,10,48,20.8333333333333
"667","1/30/2016",59,7,52,13.4615384615385
"668","1/30/2017",70,2,68,2.94117647058824
"669","1/30/2018",74,2,72,2.77777777777778
"670","1/30/2019",72,4,68,5.88235294117647
"671","1/30/2020",78,1,77,1.2987012987013
"672","1/30/2021",64,8,56,14.2857142857143
"673","1/31/1994",72,0,72,0
"674","1/31/1995",73,1,72,1.38888888888889
"675","1/31/1996",66,0,66,0
"676","1/31/1997",62,0,62,0
"677","1/31/1998",64,2,62,3.2258064516129
"678","1/31/1999",116,4,112,3.57142857142857
"679","1/31/2000",74,0,74,0
"680","1/31/2001",70,0,70,0
"681","1/31/2002",72,4,68,5.88235294117647
"682","1/31/2003",68,1,67,1.49253731343284
"683","1/31/2004",50,2,48,4.16666666666667
"684","1/31/2005",74,0,74,0
"685","1/31/2006",79,0,79,0
"686","1/31/2007",72,5,67,7.46268656716418
"687","1/31/2008",71,1,70,1.42857142857143
"688","1/31/2009",67,6,61,9.83606557377049
"689","1/31/2010",128,6,122,4.91803278688525
"690","1/31/2011",77,0,77,0
"691","1/31/2012",69,1,68,1.47058823529412
"692","1/31/2013",55,1,54,1.85185185185185
"693","1/31/2014",54,5,49,10.2040816326531
"694","1/31/2015",64,6,58,10.3448275862069
"695","1/31/2016",131,4,127,3.1496062992126
"696","1/31/2017",71,1,70,1.42857142857143
"697","1/31/2018",62,2,60,3.33333333333333
"698","1/31/2019",71,2,69,2.89855072463768
"699","1/31/2020",63,1,62,1.61290322580645
"700","1/31/2021",132,4,128,3.125
"701","1/4/1994",70,4,66,6.06060606060606
"702","1/4/1995",73,1,72,1.38888888888889
"703","1/4/1996",63,0,63,0
"704","1/4/1997",63,1,62,1.61290322580645
"705","1/4/1998",121,2,119,1.68067226890756
"706","1/4/1999",76,1,75,1.33333333333333
"707","1/4/2000",70,1,69,1.44927536231884
"708","1/4/2001",70,0,70,0
"709","1/4/2002",65,1,64,1.5625
"710","1/4/2003",57,2,55,3.63636363636364
"711","1/4/2004",123,2,121,1.65289256198347
"712","1/4/2005",78,0,78,0
"713","1/4/2006",72,1,71,1.40845070422535
"714","1/4/2007",72,3,69,4.34782608695652
"715","1/4/2008",33,0,33,0
"716","1/4/2009",129,4,125,3.2
"717","1/4/2010",76,0,76,0
"718","1/4/2011",76,1,75,1.33333333333333
"719","1/4/2012",69,2,67,2.98507462686567
"720","1/4/2013",64,2,62,3.2258064516129
"721","1/4/2014",62,8,54,14.8148148148148
"722","1/4/2015",119,6,113,5.30973451327434
"723","1/4/2016",73,0,73,0
"724","1/4/2017",68,5,63,7.93650793650794
"725","1/4/2018",59,1,58,1.72413793103448
"726","1/4/2019",67,0,67,0
"727","1/4/2020",54,2,52,3.84615384615385
"728","1/4/2021",71,1,70,1.42857142857143
"729","1/5/1994",76,2,74,2.7027027027027
"730","1/5/1995",69,4,65,6.15384615384615
"731","1/5/1996",51,0,51,0
"732","1/5/1997",121,1,120,0.833333333333333
"733","1/5/1998",77,0,77,0
"734","1/5/1999",69,0,69,0
"735","1/5/2000",68,0,68,0
"736","1/5/2001",66,3,63,4.76190476190476
"737","1/5/2002",64,2,62,3.2258064516129
"738","1/5/2003",129,5,124,4.03225806451613
"739","1/5/2004",76,1,75,1.33333333333333
"740","1/5/2005",73,2,71,2.8169014084507
"741","1/5/2006",70,1,69,1.44927536231884
"742","1/5/2007",58,4,54,7.40740740740741
"743","1/5/2008",57,4,53,7.54716981132075
"744","1/5/2009",76,0,76,0
"745","1/5/2010",75,0,75,0
"746","1/5/2011",73,2,71,2.8169014084507
"747","1/5/2012",67,2,65,3.07692307692308
"748","1/5/2013",62,1,61,1.63934426229508
"749","1/5/2014",148,7,141,4.9645390070922
"750","1/5/2015",74,1,73,1.36986301369863
"751","1/5/2016",72,1,71,1.40845070422535
"752","1/5/2017",71,2,69,2.89855072463768
"753","1/5/2018",66,3,63,4.76190476190476
"754","1/5/2019",53,1,52,1.92307692307692
"755","1/5/2020",127,1,126,0.793650793650794
"756","1/5/2021",71,1,70,1.42857142857143
"757","1/6/1994",70,3,67,4.47761194029851
"758","1/6/1995",75,0,75,0
"759","1/6/1996",58,0,58,0
"760","1/6/1997",77,1,76,1.31578947368421
"761","1/6/1998",73,2,71,2.8169014084507
"762","1/6/1999",64,0,64,0
"763","1/6/2000",71,2,69,2.89855072463768
"764","1/6/2001",64,3,61,4.91803278688525
"765","1/6/2002",112,5,107,4.67289719626168
"766","1/6/2003",73,1,72,1.38888888888889
"767","1/6/2004",73,1,72,1.38888888888889
"768","1/6/2005",62,1,61,1.63934426229508
"769","1/6/2006",60,4,56,7.14285714285714
"770","1/6/2007",48,1,47,2.12765957446809
"771","1/6/2008",127,4,123,3.2520325203252
"772","1/6/2009",74,0,74,0
"773","1/6/2010",69,3,66,4.54545454545455
"774","1/6/2011",71,9,62,14.5161290322581
"775","1/6/2012",58,2,56,3.57142857142857
"776","1/6/2013",124,6,118,5.08474576271187
"777","1/6/2014",73,1,72,1.38888888888889
"778","1/6/2015",71,2,69,2.89855072463768
"779","1/6/2016",72,5,67,7.46268656716418
"780","1/6/2017",66,2,64,3.125
"781","1/6/2018",59,5,54,9.25925925925926
"782","1/6/2019",128,5,123,4.0650406504065
"783","1/6/2020",76,0,76,0
"784","1/6/2021",65,2,63,3.17460317460317
"785","1/7/1994",73,5,68,7.35294117647059
"786","1/7/1995",56,0,56,0
"787","1/7/1996",134,5,129,3.87596899224806
"788","1/7/1997",75,3,72,4.16666666666667
"789","1/7/1998",67,3,64,4.6875
"790","1/7/1999",68,0,68,0
"791","1/7/2000",60,0,60,0
"792","1/7/2001",129,2,127,1.5748031496063
"793","1/7/2002",73,1,72,1.38888888888889
"794","1/7/2003",69,2,67,2.98507462686567
"795","1/7/2004",66,1,65,1.53846153846154
"796","1/7/2005",60,4,56,7.14285714285714
"797","1/7/2006",57,4,53,7.54716981132075
"798","1/7/2007",123,2,121,1.65289256198347
"799","1/7/2008",77,0,77,0
"800","1/7/2009",71,4,67,5.97014925373134
"801","1/7/2010",70,3,67,4.47761194029851
"802","1/7/2011",60,4,56,7.14285714285714
"803","1/7/2012",57,3,54,5.55555555555556
"804","1/7/2013",74,0,74,0
"805","1/7/2014",71,0,71,0
"806","1/7/2015",73,2,71,2.8169014084507
"807","1/7/2016",73,6,67,8.95522388059701
"808","1/7/2017",61,3,58,5.17241379310345
"809","1/7/2018",121,2,119,1.68067226890756
"810","1/7/2019",74,2,72,2.77777777777778
"811","1/7/2020",67,1,66,1.51515151515152
"812","1/7/2021",68,3,65,4.61538461538462
"813","1/8/1994",65,2,63,3.17460317460317
"814","1/8/1995",125,2,123,1.6260162601626
"815","1/8/1996",76,0,76,0
"816","1/8/1997",74,2,72,2.77777777777778
"817","1/8/1998",74,0,74,0
"818","1/8/1999",65,4,61,6.55737704918033
"819","1/8/2000",64,5,59,8.47457627118644
"820","1/8/2001",75,0,75,0
"821","1/8/2002",73,2,71,2.8169014084507
"822","1/8/2003",72,2,70,2.85714285714286
"823","1/8/2004",68,3,65,4.61538461538462
"824","1/8/2005",62,3,59,5.08474576271187
"825","1/8/2006",124,6,118,5.08474576271187
"826","1/8/2007",71,1,70,1.42857142857143
"827","1/8/2008",69,1,68,1.47058823529412
"828","1/8/2009",69,3,66,4.54545454545455
"829","1/8/2010",64,6,58,10.3448275862069
"830","1/8/2011",58,4,54,7.40740740740741
"831","1/8/2012",128,6,122,4.91803278688525
"832","1/8/2013",69,0,69,0
"833","1/8/2014",72,1,71,1.40845070422535
"834","1/8/2015",74,3,71,4.22535211267606
"835","1/8/2016",58,5,53,9.43396226415094
"836","1/8/2017",117,2,115,1.73913043478261
"837","1/8/2018",66,0,66,0
"838","1/8/2019",74,2,72,2.77777777777778
"839","1/8/2020",69,2,67,2.98507462686567
"840","1/8/2021",63,4,59,6.77966101694915
"841","1/9/1994",125,4,121,3.30578512396694
"842","1/9/1995",73,0,73,0
"843","1/9/1996",76,0,76,0
"844","1/9/1997",73,0,73,0
"845","1/9/1998",62,1,61,1.63934426229508
"846","1/9/1999",61,4,57,7.01754385964912
"847","1/9/2000",126,12,114,10.5263157894737
"848","1/9/2001",71,1,70,1.42857142857143
"849","1/9/2002",69,2,67,2.98507462686567
"850","1/9/2003",67,2,65,3.07692307692308
"851","1/9/2004",63,3,60,5
"852","1/9/2005",123,4,119,3.36134453781513
"853","1/9/2006",73,0,73,0
"854","1/9/2007",77,1,76,1.31578947368421
"855","1/9/2008",70,2,68,2.94117647058824
"856","1/9/2009",57,3,54,5.55555555555556
"857","1/9/2010",61,1,60,1.66666666666667
"858","1/9/2011",127,4,123,3.2520325203252
"859","1/9/2012",73,1,72,1.38888888888889
"860","1/9/2013",71,1,70,1.42857142857143
"861","1/9/2014",73,2,71,2.8169014084507
"862","1/9/2015",57,4,53,7.54716981132075
"863","1/9/2016",65,3,62,4.83870967741935
"864","1/9/2017",74,1,73,1.36986301369863
"865","1/9/2018",75,3,72,4.16666666666667
"866","1/9/2019",74,4,70,5.71428571428571
"867","1/9/2020",65,2,63,3.17460317460317
"868","1/9/2021",68,4,64,6.25
"869","10/1/1994",61,4,57,7.01754385964912
"870","10/1/1995",124,1,123,0.813008130081301
"871","10/1/1996",73,0,73,0
"872","10/1/1997",71,0,71,0
"873","10/1/1998",68,4,64,6.25
"874","10/1/1999",64,6,58,10.3448275862069
"875","10/1/2000",159,6,153,3.92156862745098
"876","10/1/2001",74,1,73,1.36986301369863
"877","10/1/2002",74,2,72,2.77777777777778
"878","10/1/2003",67,0,67,0
"879","10/1/2004",58,1,57,1.75438596491228
"880","10/1/2005",55,0,55,0
"881","10/1/2006",127,3,124,2.41935483870968
"882","10/1/2007",71,0,71,0
"883","10/1/2008",78,1,77,1.2987012987013
"884","10/1/2009",70,6,64,9.375
"885","10/1/2010",69,3,66,4.54545454545455
"886","10/1/2011",61,2,59,3.38983050847458
"887","10/1/2012",73,2,71,2.8169014084507
"888","10/1/2013",72,2,70,2.85714285714286
"889","10/1/2014",73,5,68,7.35294117647059
"890","10/1/2015",68,1,67,1.49253731343284
"891","10/1/2016",55,3,52,5.76923076923077
"892","10/1/2017",141,1,140,0.714285714285714
"893","10/1/2018",71,0,71,0
"894","10/1/2019",73,3,70,4.28571428571429
"895","10/1/2020",66,0,66,0
"896","10/1/2021",61,4,57,7.01754385964912
"897","10/10/1994",76,0,76,0
"898","10/10/1995",73,0,73,0
"899","10/10/1996",63,1,62,1.61290322580645
"900","10/10/1997",60,2,58,3.44827586206897
"901","10/10/1998",65,5,60,8.33333333333333
"902","10/10/1999",128,4,124,3.2258064516129
"903","10/10/2000",73,0,73,0
"904","10/10/2001",74,1,73,1.36986301369863
"905","10/10/2002",74,2,72,2.77777777777778
"906","10/10/2003",62,2,60,3.33333333333333
"907","10/10/2004",123,4,119,3.36134453781513
"908","10/10/2005",75,0,75,0
"909","10/10/2006",70,2,68,2.94117647058824
"910","10/10/2007",70,1,69,1.44927536231884
"911","10/10/2008",65,4,61,6.55737704918033
"912","10/10/2009",67,6,61,9.83606557377049
"913","10/10/2010",127,1,126,0.793650793650794
"914","10/10/2011",75,0,75,0
"915","10/10/2012",70,1,69,1.44927536231884
"916","10/10/2013",61,2,59,3.38983050847458
"917","10/10/2014",59,4,55,7.27272727272727
"918","10/10/2015",66,5,61,8.19672131147541
"919","10/10/2016",74,0,74,0
"920","10/10/2017",75,3,72,4.16666666666667
"921","10/10/2018",76,3,73,4.10958904109589
"922","10/10/2019",71,1,70,1.42857142857143
"923","10/10/2020",63,3,60,5
"924","10/10/2021",125,7,118,5.93220338983051
"925","10/11/1994",72,1,71,1.40845070422535
"926","10/11/1995",71,0,71,0
"927","10/11/1996",58,4,54,7.40740740740741
"928","10/11/1997",57,0,57,0
"929","10/11/1998",131,3,128,2.34375
"930","10/11/1999",75,1,74,1.35135135135135
"931","10/11/2000",71,1,70,1.42857142857143
"932","10/11/2001",73,1,72,1.38888888888889
"933","10/11/2002",69,3,66,4.54545454545455
"934","10/11/2003",58,1,57,1.75438596491228
"935","10/11/2004",67,0,67,0
"936","10/11/2005",73,0,73,0
"937","10/11/2006",72,1,71,1.40845070422535
"938","10/11/2007",73,2,71,2.8169014084507
"939","10/11/2008",67,3,64,4.6875
"940","10/11/2009",121,3,118,2.54237288135593
"941","10/11/2010",74,0,74,0
"942","10/11/2011",67,1,66,1.51515151515152
"943","10/11/2012",55,0,55,0
"944","10/11/2013",61,6,55,10.9090909090909
"945","10/11/2014",64,9,55,16.3636363636364
"946","10/11/2015",132,6,126,4.76190476190476
"947","10/11/2016",74,3,71,4.22535211267606
"948","10/11/2017",71,2,69,2.89855072463768
"949","10/11/2018",70,3,67,4.47761194029851
"950","10/11/2019",62,7,55,12.7272727272727
"951","10/11/2020",130,6,124,4.83870967741935
"952","10/11/2021",69,2,67,2.98507462686567
"953","10/12/1994",74,0,74,0
"954","10/12/1995",71,0,71,0
"955","10/12/1996",64,0,64,0
"956","10/12/1997",124,4,120,3.33333333333333
"957","10/12/1998",74,0,74,0
"958","10/12/1999",71,0,71,0
"959","10/12/2000",70,0,70,0
"960","10/12/2001",57,3,54,5.55555555555556
"961","10/12/2002",71,2,69,2.89855072463768
"962","10/12/2003",128,3,125,2.4
"963","10/12/2004",73,1,72,1.38888888888889
"964","10/12/2005",74,4,70,5.71428571428571
"965","10/12/2006",64,0,64,0
"966","10/12/2007",61,5,56,8.92857142857143
"967","10/12/2008",129,8,121,6.61157024793388
"968","10/12/2009",74,0,74,0
"969","10/12/2010",74,3,71,4.22535211267606
"970","10/12/2011",68,2,66,3.03030303030303
"971","10/12/2012",63,6,57,10.5263157894737
"972","10/12/2013",60,2,58,3.44827586206897
"973","10/12/2014",133,6,127,4.7244094488189
"974","10/12/2015",76,1,75,1.33333333333333
"975","10/12/2016",65,2,63,3.17460317460317
"976","10/12/2017",73,3,70,4.28571428571429
"977","10/12/2018",66,1,65,1.53846153846154
"978","10/12/2019",65,3,62,4.83870967741935
"979","10/12/2020",78,1,77,1.2987012987013
"980","10/12/2021",70,2,68,2.94117647058824
"981","10/13/1994",69,3,66,4.54545454545455
"982","10/13/1995",61,2,59,3.38983050847458
"983","10/13/1996",120,1,119,0.840336134453782
"984","10/13/1997",75,0,75,0
"985","10/13/1998",73,0,73,0
"986","10/13/1999",73,1,72,1.38888888888889
"987","10/13/2000",62,4,58,6.89655172413793
"988","10/13/2001",66,3,63,4.76190476190476
"989","10/13/2002",122,3,119,2.52100840336134
"990","10/13/2003",76,1,75,1.33333333333333
"991","10/13/2004",71,1,70,1.42857142857143
"992","10/13/2005",61,1,60,1.66666666666667
"993","10/13/2006",59,1,58,1.72413793103448
"994","10/13/2007",61,5,56,8.92857142857143
"995","10/13/2008",75,0,75,0
"996","10/13/2009",76,0,76,0
"997","10/13/2010",71,5,66,7.57575757575758
"998","10/13/2011",70,6,64,9.375
"999","10/13/2012",68,6,62,9.67741935483871
"1000","10/13/2013",133,5,128,3.90625
"1001","10/13/2014",77,0,77,0
"1002","10/13/2015",76,0,76,0
"1003","10/13/2016",71,3,68,4.41176470588235
"1004","10/13/2017",65,4,61,6.55737704918033
"1005","10/13/2018",55,4,51,7.84313725490196
"1006","10/13/2019",125,4,121,3.30578512396694
"1007","10/13/2020",69,3,66,4.54545454545455
"1008","10/13/2021",72,0,72,0
"1009","10/14/1994",67,0,67,0
"1010","10/14/1995",57,1,56,1.78571428571429
"1011","10/14/1996",69,0,69,0
"1012","10/14/1997",69,0,69,0
"1013","10/14/1998",72,1,71,1.40845070422535
"1014","10/14/1999",66,1,65,1.53846153846154
"1015","10/14/2000",63,2,61,3.27868852459016
"1016","10/14/2001",126,2,124,1.61290322580645
"1017","10/14/2002",77,0,77,0
"1018","10/14/2003",73,1,72,1.38888888888889
"1019","10/14/2004",67,2,65,3.07692307692308
"1020","10/14/2005",66,4,62,6.45161290322581
"1021","10/14/2006",51,3,48,6.25
"1022","10/14/2007",129,2,127,1.5748031496063
"1023","10/14/2008",74,1,73,1.36986301369863
"1024","10/14/2009",74,1,73,1.36986301369863
"1025","10/14/2010",74,4,70,5.71428571428571
"1026","10/14/2011",64,7,57,12.280701754386
"1027","10/14/2012",122,3,119,2.52100840336134
"1028","10/14/2013",71,1,70,1.42857142857143
"1029","10/14/2014",71,4,67,5.97014925373134
"1030","10/14/2015",65,1,64,1.5625
"1031","10/14/2016",57,2,55,3.63636363636364
"1032","10/14/2017",63,5,58,8.62068965517241
"1033","10/14/2018",115,2,113,1.76991150442478
"1034","10/14/2019",75,0,75,0
"1035","10/14/2020",69,3,66,4.54545454545455
"1036","10/14/2021",68,6,62,9.67741935483871
"1037","10/15/1994",52,2,50,4
"1038","10/15/1995",128,4,124,3.2258064516129
"1039","10/15/1996",75,0,75,0
"1040","10/15/1997",74,1,73,1.36986301369863
"1041","10/15/1998",66,3,63,4.76190476190476
"1042","10/15/1999",57,0,57,0
"1043","10/15/2000",121,7,114,6.14035087719298
"1044","10/15/2001",72,0,72,0
"1045","10/15/2002",76,7,69,10.1449275362319
"1046","10/15/2003",74,2,72,2.77777777777778
"1047","10/15/2004",66,3,63,4.76190476190476
"1048","10/15/2005",57,0,57,0
"1049","10/15/2006",130,5,125,4
"1050","10/15/2007",73,0,73,0
"1051","10/15/2008",73,3,70,4.28571428571429
"1052","10/15/2009",73,2,71,2.8169014084507
"1053","10/15/2010",63,2,61,3.27868852459016
"1054","10/15/2011",64,6,58,10.3448275862069
"1055","10/15/2012",75,4,71,5.63380281690141
"1056","10/15/2013",73,1,72,1.38888888888889
"1057","10/15/2014",68,0,68,0
"1058","10/15/2015",66,2,64,3.125
"1059","10/15/2016",50,6,44,13.6363636363636
"1060","10/15/2017",126,6,120,5
"1061","10/15/2018",72,1,71,1.40845070422535
"1062","10/15/2019",74,1,73,1.36986301369863
"1063","10/15/2020",66,2,64,3.125
"1064","10/15/2021",60,3,57,5.26315789473684
"1065","10/16/1994",116,4,112,3.57142857142857
"1066","10/16/1995",66,0,66,0
"1067","10/16/1996",68,0,68,0
"1068","10/16/1997",71,3,68,4.41176470588235
"1069","10/16/1998",66,6,60,10
"1070","10/16/1999",62,6,56,10.7142857142857
"1071","10/16/2000",70,2,68,2.94117647058824
"1072","10/16/2001",74,2,72,2.77777777777778
"1073","10/16/2002",76,2,74,2.7027027027027
"1074","10/16/2003",69,2,67,2.98507462686567
"1075","10/16/2004",64,4,60,6.66666666666667
"1076","10/16/2005",130,2,128,1.5625
"1077","10/16/2006",75,0,75,0
"1078","10/16/2007",70,1,69,1.44927536231884
"1079","10/16/2008",67,2,65,3.07692307692308
"1080","10/16/2009",64,3,61,4.91803278688525
"1081","10/16/2010",58,3,55,5.45454545454545
"1082","10/16/2011",136,4,132,3.03030303030303
"1083","10/16/2012",69,0,69,0
"1084","10/16/2013",69,0,69,0
"1085","10/16/2014",73,5,68,7.35294117647059
"1086","10/16/2015",46,5,41,12.1951219512195
"1087","10/16/2016",128,5,123,4.0650406504065
"1088","10/16/2017",71,0,71,0
"1089","10/16/2018",75,1,74,1.35135135135135
"1090","10/16/2019",70,2,68,2.94117647058824
"1091","10/16/2020",67,4,63,6.34920634920635
"1092","10/16/2021",69,7,62,11.2903225806452
"1093","10/17/1994",73,1,72,1.38888888888889
"1094","10/17/1995",72,0,72,0
"1095","10/17/1996",64,1,63,1.58730158730159
"1096","10/17/1997",62,2,60,3.33333333333333
"1097","10/17/1998",60,1,59,1.69491525423729
"1098","10/17/1999",164,14,150,9.33333333333333
"1099","10/17/2000",75,1,74,1.35135135135135
"1100","10/17/2001",74,1,73,1.36986301369863
"1101","10/17/2002",63,2,61,3.27868852459016
"1102","10/17/2003",58,1,57,1.75438596491228
"1103","10/17/2004",124,3,121,2.47933884297521
"1104","10/17/2005",77,0,77,0
"1105","10/17/2006",69,0,69,0
"1106","10/17/2007",70,0,70,0
"1107","10/17/2008",45,3,42,7.14285714285714
"1108","10/17/2009",57,4,53,7.54716981132075
"1109","10/17/2010",119,7,112,6.25
"1110","10/17/2011",68,0,68,0
"1111","10/17/2012",69,0,69,0
"1112","10/17/2013",69,3,66,4.54545454545455
"1113","10/17/2014",60,7,53,13.2075471698113
"1114","10/17/2015",61,3,58,5.17241379310345
"1115","10/17/2016",76,2,74,2.7027027027027
"1116","10/17/2017",67,1,66,1.51515151515152
"1117","10/17/2018",74,2,72,2.77777777777778
"1118","10/17/2019",63,3,60,5
"1119","10/17/2020",67,5,62,8.06451612903226
"1120","10/17/2021",131,4,127,3.1496062992126
"1121","10/18/1994",73,2,71,2.8169014084507
"1122","10/18/1995",70,2,68,2.94117647058824
"1123","10/18/1996",62,2,60,3.33333333333333
"1124","10/18/1997",61,3,58,5.17241379310345
"1125","10/18/1998",127,7,120,5.83333333333333
"1126","10/18/1999",72,0,72,0
"1127","10/18/2000",72,2,70,2.85714285714286
"1128","10/18/2001",74,4,70,5.71428571428571
"1129","10/18/2002",60,2,58,3.44827586206897
"1130","10/18/2003",63,2,61,3.27868852459016
"1131","10/18/2004",76,0,76,0
"1132","10/18/2005",69,0,69,0
"1133","10/18/2006",78,3,75,4
"1134","10/18/2007",74,0,74,0
"1135","10/18/2008",65,4,61,6.55737704918033
"1136","10/18/2009",129,7,122,5.73770491803279
"1137","10/18/2010",72,2,70,2.85714285714286
"1138","10/18/2011",71,0,71,0
"1139","10/18/2012",70,7,63,11.1111111111111
"1140","10/18/2013",56,4,52,7.69230769230769
"1141","10/18/2014",64,6,58,10.3448275862069
"1142","10/18/2015",128,6,122,4.91803278688525
"1143","10/18/2016",71,5,66,7.57575757575758
"1144","10/18/2017",75,3,72,4.16666666666667
"1145","10/18/2018",64,2,62,3.2258064516129
"1146","10/18/2019",61,1,60,1.66666666666667
"1147","10/18/2020",129,5,124,4.03225806451613
"1148","10/18/2021",73,2,71,2.8169014084507
"1149","10/19/1994",65,0,65,0
"1150","10/19/1995",67,1,66,1.51515151515152
"1151","10/19/1996",68,2,66,3.03030303030303
"1152","10/19/1997",122,2,120,1.66666666666667
"1153","10/19/1998",76,0,76,0
"1154","10/19/1999",73,1,72,1.38888888888889
"1155","10/19/2000",68,3,65,4.61538461538462
"1156","10/19/2001",65,2,63,3.17460317460317
"1157","10/19/2002",64,3,61,4.91803278688525
"1158","10/19/2003",131,2,129,1.55038759689922
"1159","10/19/2004",74,2,72,2.77777777777778
"1160","10/19/2005",74,2,72,2.77777777777778
"1161","10/19/2006",70,4,66,6.06060606060606
"1162","10/19/2007",68,2,66,3.03030303030303
"1163","10/19/2008",118,3,115,2.60869565217391
"1164","10/19/2009",76,0,76,0
"1165","10/19/2010",74,0,74,0
"1166","10/19/2011",74,3,71,4.22535211267606
"1167","10/19/2012",55,1,54,1.85185185185185
"1168","10/19/2013",54,0,54,0
"1169","10/19/2014",123,7,116,6.03448275862069
"1170","10/19/2015",74,0,74,0
"1171","10/19/2016",71,5,66,7.57575757575758
"1172","10/19/2017",75,0,75,0
"1173","10/19/2018",63,2,61,3.27868852459016
"1174","10/19/2019",54,5,49,10.2040816326531
"1175","10/19/2020",75,0,75,0
"1176","10/19/2021",67,2,65,3.07692307692308
"1177","10/2/1994",127,1,126,0.793650793650794
"1178","10/2/1995",73,0,73,0
"1179","10/2/1996",71,4,67,5.97014925373134
"1180","10/2/1997",67,0,67,0
"1181","10/2/1998",67,1,66,1.51515151515152
"1182","10/2/1999",63,3,60,5
"1183","10/2/2000",77,0,77,0
"1184","10/2/2001",74,2,72,2.77777777777778
"1185","10/2/2002",70,0,70,0
"1186","10/2/2003",67,2,65,3.07692307692308
"1187","10/2/2004",64,3,61,4.91803278688525
"1188","10/2/2005",132,0,132,0
"1189","10/2/2006",75,0,75,0
"1190","10/2/2007",75,1,74,1.35135135135135
"1191","10/2/2008",66,0,66,0
"1192","10/2/2009",62,1,61,1.63934426229508
"1193","10/2/2010",62,7,55,12.7272727272727
"1194","10/2/2011",122,2,120,1.66666666666667
"1195","10/2/2012",66,3,63,4.76190476190476
"1196","10/2/2013",70,1,69,1.44927536231884
"1197","10/2/2014",70,3,67,4.47761194029851
"1198","10/2/2015",58,6,52,11.5384615384615
"1199","10/2/2016",126,8,118,6.77966101694915
"1200","10/2/2017",72,1,71,1.40845070422535
"1201","10/2/2018",69,1,68,1.47058823529412
"1202","10/2/2019",74,1,73,1.36986301369863
"1203","10/2/2020",68,3,65,4.61538461538462
"1204","10/2/2021",62,3,59,5.08474576271187
"1205","10/20/1994",69,1,68,1.47058823529412
"1206","10/20/1995",62,1,61,1.63934426229508
"1207","10/20/1996",116,2,114,1.75438596491228
"1208","10/20/1997",74,1,73,1.36986301369863
"1209","10/20/1998",72,1,71,1.40845070422535
"1210","10/20/1999",74,2,72,2.77777777777778
"1211","10/20/2000",63,6,57,10.5263157894737
"1212","10/20/2001",46,1,45,2.22222222222222
"1213","10/20/2002",128,2,126,1.58730158730159
"1214","10/20/2003",72,0,72,0
"1215","10/20/2004",69,3,66,4.54545454545455
"1216","10/20/2005",63,3,60,5
"1217","10/20/2006",70,3,67,4.47761194029851
"1218","10/20/2007",52,1,51,1.96078431372549
"1219","10/20/2008",69,0,69,0
"1220","10/20/2009",73,0,73,0
"1221","10/20/2010",70,2,68,2.94117647058824
"1222","10/20/2011",71,4,67,5.97014925373134
"1223","10/20/2012",61,5,56,8.92857142857143
"1224","10/20/2013",156,8,148,5.40540540540541
"1225","10/20/2014",75,0,75,0
"1226","10/20/2015",74,0,74,0
"1227","10/20/2016",71,6,65,9.23076923076923
"1228","10/20/2017",64,4,60,6.66666666666667
"1229","10/20/2018",61,6,55,10.9090909090909
"1230","10/20/2019",128,2,126,1.58730158730159
"1231","10/20/2020",73,2,71,2.8169014084507
"1232","10/20/2021",75,3,72,4.16666666666667
"1233","10/21/1994",63,2,61,3.27868852459016
"1234","10/21/1995",68,0,68,0
"1235","10/21/1996",74,0,74,0
"1236","10/21/1997",75,1,74,1.35135135135135
"1237","10/21/1998",71,3,68,4.41176470588235
"1238","10/21/1999",68,2,66,3.03030303030303
"1239","10/21/2000",56,5,51,9.80392156862745
"1240","10/21/2001",130,2,128,1.5625
"1241","10/21/2002",71,1,70,1.42857142857143
"1242","10/21/2003",73,1,72,1.38888888888889
"1243","10/21/2004",69,3,66,4.54545454545455
"1244","10/21/2005",69,4,65,6.15384615384615
"1245","10/21/2006",60,2,58,3.44827586206897
"1246","10/21/2007",121,2,119,1.68067226890756
"1247","10/21/2008",71,2,69,2.89855072463768
"1248","10/21/2009",76,2,74,2.7027027027027
"1249","10/21/2010",67,2,65,3.07692307692308
"1250","10/21/2011",65,7,58,12.0689655172414
"1251","10/21/2012",128,7,121,5.78512396694215
"1252","10/21/2013",71,1,70,1.42857142857143
"1253","10/21/2014",70,2,68,2.94117647058824
"1254","10/21/2015",74,1,73,1.36986301369863
"1255","10/21/2016",62,7,55,12.7272727272727
"1256","10/21/2017",62,2,60,3.33333333333333
"1257","10/21/2018",133,7,126,5.55555555555556
"1258","10/21/2019",72,0,72,0
"1259","10/21/2020",68,0,68,0
"1260","10/21/2021",67,3,64,4.6875
"1261","10/22/1994",61,2,59,3.38983050847458
"1262","10/22/1995",143,1,142,0.704225352112676
"1263","10/22/1996",74,1,73,1.36986301369863
"1264","10/22/1997",75,0,75,0
"1265","10/22/1998",72,2,70,2.85714285714286
"1266","10/22/1999",58,3,55,5.45454545454545
"1267","10/22/2000",124,6,118,5.08474576271187
"1268","10/22/2001",74,0,74,0
"1269","10/22/2002",74,1,73,1.36986301369863
"1270","10/22/2003",73,0,73,0
"1271","10/22/2004",59,1,58,1.72413793103448
"1272","10/22/2005",55,1,54,1.85185185185185
"1273","10/22/2006",120,1,119,0.840336134453782
"1274","10/22/2007",73,0,73,0
"1275","10/22/2008",72,3,69,4.34782608695652
"1276","10/22/2009",72,2,70,2.85714285714286
"1277","10/22/2010",69,5,64,7.8125
"1278","10/22/2011",71,3,68,4.41176470588235
"1279","10/22/2012",73,0,73,0
"1280","10/22/2013",68,1,67,1.49253731343284
"1281","10/22/2014",73,1,72,1.38888888888889
"1282","10/22/2015",66,3,63,4.76190476190476
"1283","10/22/2016",65,6,59,10.1694915254237
"1284","10/22/2017",126,1,125,0.8
"1285","10/22/2018",74,0,74,0
"1286","10/22/2019",76,4,72,5.55555555555556
"1287","10/22/2020",72,3,69,4.34782608695652
"1288","10/22/2021",63,4,59,6.77966101694915
"1289","10/23/1994",127,0,127,0
"1290","10/23/1995",78,1,77,1.2987012987013
"1291","10/23/1996",73,4,69,5.79710144927536
"1292","10/23/1997",74,0,74,0
"1293","10/23/1998",58,1,57,1.75438596491228
"1294","10/23/1999",62,3,59,5.08474576271187
"1295","10/23/2000",72,3,69,4.34782608695652
"1296","10/23/2001",68,0,68,0
"1297","10/23/2002",70,3,67,4.47761194029851
"1298","10/23/2003",71,4,67,5.97014925373134
"1299","10/23/2004",59,2,57,3.50877192982456
"1300","10/23/2005",126,6,120,5
"1301","10/23/2006",72,0,72,0
"1302","10/23/2007",73,1,72,1.38888888888889
"1303","10/23/2008",70,2,68,2.94117647058824
"1304","10/23/2009",64,3,61,4.91803278688525
"1305","10/23/2010",60,5,55,9.09090909090909
"1306","10/23/2011",124,5,119,4.20168067226891
"1307","10/23/2012",73,3,70,4.28571428571429
"1308","10/23/2013",71,1,70,1.42857142857143
"1309","10/23/2014",75,7,68,10.2941176470588
"1310","10/23/2015",68,5,63,7.93650793650794
"1311","10/23/2016",130,3,127,2.36220472440945
"1312","10/23/2017",75,6,69,8.69565217391304
"1313","10/23/2018",72,1,71,1.40845070422535
"1314","10/23/2019",74,0,74,0
"1315","10/23/2020",63,3,60,5
"1316","10/23/2021",58,4,54,7.40740740740741
"1317","10/24/1994",74,1,73,1.36986301369863
"1318","10/24/1995",72,0,72,0
"1319","10/24/1996",74,0,74,0
"1320","10/24/1997",38,2,36,5.55555555555556
"1321","10/24/1998",71,3,68,4.41176470588235
"1322","10/24/1999",131,5,126,3.96825396825397
"1323","10/24/2000",73,2,71,2.8169014084507
"1324","10/24/2001",73,2,71,2.8169014084507
"1325","10/24/2002",73,1,72,1.38888888888889
"1326","10/24/2003",63,3,60,5
"1327","10/24/2004",124,5,119,4.20168067226891
"1328","10/24/2005",77,0,77,0
"1329","10/24/2006",74,0,74,0
"1330","10/24/2007",73,1,72,1.38888888888889
"1331","10/24/2008",66,3,63,4.76190476190476
"1332","10/24/2009",57,6,51,11.7647058823529
"1333","10/24/2010",121,3,118,2.54237288135593
"1334","10/24/2011",74,3,71,4.22535211267606
"1335","10/24/2012",75,3,72,4.16666666666667
"1336","10/24/2013",69,7,62,11.2903225806452
"1337","10/24/2014",64,4,60,6.66666666666667
"1338","10/24/2015",57,6,51,11.7647058823529
"1339","10/24/2016",72,0,72,0
"1340","10/24/2017",76,4,72,5.55555555555556
"1341","10/24/2018",68,1,67,1.49253731343284
"1342","10/24/2019",70,3,67,4.47761194029851
"1343","10/24/2020",53,3,50,6
"1344","10/24/2021",130,6,124,4.83870967741935
"1345","10/25/1994",69,1,68,1.47058823529412
"1346","10/25/1995",69,1,68,1.47058823529412
"1347","10/25/1996",62,2,60,3.33333333333333
"1348","10/25/1997",62,1,61,1.63934426229508
"1349","10/25/1998",129,2,127,1.5748031496063
"1350","10/25/1999",74,2,72,2.77777777777778
"1351","10/25/2000",73,1,72,1.38888888888889
"1352","10/25/2001",67,1,66,1.51515151515152
"1353","10/25/2002",61,3,58,5.17241379310345
"1354","10/25/2003",62,0,62,0
"1355","10/25/2004",73,2,71,2.8169014084507
"1356","10/25/2005",73,0,73,0
"1357","10/25/2006",73,1,72,1.38888888888889
"1358","10/25/2007",67,0,67,0
"1359","10/25/2008",58,3,55,5.45454545454545
"1360","10/25/2009",126,3,123,2.4390243902439
"1361","10/25/2010",74,3,71,4.22535211267606
"1362","10/25/2011",71,0,71,0
"1363","10/25/2012",59,2,57,3.50877192982456
"1364","10/25/2013",53,4,49,8.16326530612245
"1365","10/25/2014",65,10,55,18.1818181818182
"1366","10/25/2015",131,5,126,3.96825396825397
"1367","10/25/2016",77,1,76,1.31578947368421
"1368","10/25/2017",73,1,72,1.38888888888889
"1369","10/25/2018",71,2,69,2.89855072463768
"1370","10/25/2019",66,3,63,4.76190476190476
"1371","10/25/2020",131,5,126,3.96825396825397
"1372","10/25/2021",74,3,71,4.22535211267606
"1373","10/26/1994",70,0,70,0
"1374","10/26/1995",70,2,68,2.94117647058824
"1375","10/26/1996",67,0,67,0
"1376","10/26/1997",134,4,130,3.07692307692308
"1377","10/26/1998",75,0,75,0
"1378","10/26/1999",72,3,69,4.34782608695652
"1379","10/26/2000",70,1,69,1.44927536231884
"1380","10/26/2001",68,1,67,1.49253731343284
"1381","10/26/2002",67,1,66,1.51515151515152
"1382","10/26/2003",159,2,157,1.27388535031847
"1383","10/26/2004",70,2,68,2.94117647058824
"1384","10/26/2005",74,1,73,1.36986301369863
"1385","10/26/2006",72,3,69,4.34782608695652
"1386","10/26/2007",64,4,60,6.66666666666667
"1387","10/26/2008",120,4,116,3.44827586206897
"1388","10/26/2009",70,1,69,1.44927536231884
"1389","10/26/2010",76,1,75,1.33333333333333
"1390","10/26/2011",67,11,56,19.6428571428571
"1391","10/26/2012",58,2,56,3.57142857142857
"1392","10/26/2013",61,8,53,15.0943396226415
"1393","10/26/2014",127,5,122,4.0983606557377
"1394","10/26/2015",79,2,77,2.5974025974026
"1395","10/26/2016",66,1,65,1.53846153846154
"1396","10/26/2017",76,3,73,4.10958904109589
"1397","10/26/2018",60,3,57,5.26315789473684
"1398","10/26/2019",53,2,51,3.92156862745098
"1399","10/26/2020",74,1,73,1.36986301369863
"1400","10/26/2021",73,1,72,1.38888888888889
"1401","10/27/1994",73,3,70,4.28571428571429
"1402","10/27/1995",52,2,50,4
"1403","10/27/1996",125,4,121,3.30578512396694
"1404","10/27/1997",76,2,74,2.7027027027027
"1405","10/27/1998",76,0,76,0
"1406","10/27/1999",75,2,73,2.73972602739726
"1407","10/27/2000",59,3,56,5.35714285714286
"1408","10/27/2001",67,2,65,3.07692307692308
"1409","10/27/2002",129,2,127,1.5748031496063
"1410","10/27/2003",76,1,75,1.33333333333333
"1411","10/27/2004",72,0,72,0
"1412","10/27/2005",74,2,72,2.77777777777778
"1413","10/27/2006",65,1,64,1.5625
"1414","10/27/2007",61,2,59,3.38983050847458
"1415","10/27/2008",73,1,72,1.38888888888889
"1416","10/27/2009",69,0,69,0
"1417","10/27/2010",71,4,67,5.97014925373134
"1418","10/27/2011",65,3,62,4.83870967741935
"1419","10/27/2012",60,5,55,9.09090909090909
"1420","10/27/2013",128,5,123,4.0650406504065
"1421","10/27/2014",74,0,74,0
"1422","10/27/2015",71,1,70,1.42857142857143
"1423","10/27/2016",74,3,71,4.22535211267606
"1424","10/27/2017",64,3,61,4.91803278688525
"1425","10/27/2018",51,6,45,13.3333333333333
"1426","10/27/2019",133,2,131,1.52671755725191
"1427","10/27/2020",76,1,75,1.33333333333333
"1428","10/27/2021",69,2,67,2.98507462686567
"1429","10/28/1994",58,1,57,1.75438596491228
"1430","10/28/1995",58,1,57,1.75438596491228
"1431","10/28/1996",74,0,74,0
"1432","10/28/1997",74,0,74,0
"1433","10/28/1998",69,1,68,1.47058823529412
"1434","10/28/1999",63,2,61,3.27868852459016
"1435","10/28/2000",64,3,61,4.91803278688525
"1436","10/28/2001",127,5,122,4.0983606557377
"1437","10/28/2002",75,0,75,0
"1438","10/28/2003",71,0,71,0
"1439","10/28/2004",69,0,69,0
"1440","10/28/2005",61,4,57,7.01754385964912
"1441","10/28/2006",60,1,59,1.69491525423729
"1442","10/28/2007",129,3,126,2.38095238095238
"1443","10/28/2008",72,0,72,0
"1444","10/28/2009",65,0,65,0
"1445","10/28/2010",69,2,67,2.98507462686567
"1446","10/28/2011",51,4,47,8.51063829787234
"1447","10/28/2012",127,11,116,9.48275862068965
"1448","10/28/2013",75,1,74,1.35135135135135
"1449","10/28/2014",74,3,71,4.22535211267606
"1450","10/28/2015",74,5,69,7.2463768115942
"1451","10/28/2016",62,1,61,1.63934426229508
"1452","10/28/2017",51,1,50,2
"1453","10/28/2018",124,6,118,5.08474576271187
"1454","10/28/2019",74,0,74,0
"1455","10/28/2020",73,2,71,2.8169014084507
"1456","10/28/2021",72,2,70,2.85714285714286
"1457","10/29/1994",54,0,54,0
"1458","10/29/1995",130,2,128,1.5625
"1459","10/29/1996",71,1,70,1.42857142857143
"1460","10/29/1997",70,1,69,1.44927536231884
"1461","10/29/1998",73,0,73,0
"1462","10/29/1999",66,4,62,6.45161290322581
"1463","10/29/2000",121,6,115,5.21739130434783
"1464","10/29/2001",76,0,76,0
"1465","10/29/2002",74,2,72,2.77777777777778
"1466","10/29/2003",74,5,69,7.2463768115942
"1467","10/29/2004",60,5,55,9.09090909090909
"1468","10/29/2005",62,0,62,0
"1469","10/29/2006",124,4,120,3.33333333333333
"1470","10/29/2007",73,1,72,1.38888888888889
"1471","10/29/2008",69,0,69,0
"1472","10/29/2009",61,3,58,5.17241379310345
"1473","10/29/2010",70,5,65,7.69230769230769
"1474","10/29/2011",64,5,59,8.47457627118644
"1475","10/29/2012",77,1,76,1.31578947368421
"1476","10/29/2013",75,2,73,2.73972602739726
"1477","10/29/2014",75,8,67,11.9402985074627
"1478","10/29/2015",76,2,74,2.7027027027027
"1479","10/29/2016",58,5,53,9.43396226415094
"1480","10/29/2017",128,3,125,2.4
"1481","10/29/2018",74,0,74,0
"1482","10/29/2019",77,3,74,4.05405405405405
"1483","10/29/2020",75,1,74,1.35135135135135
"1484","10/29/2021",64,2,62,3.2258064516129
"1485","10/3/1994",73,2,71,2.8169014084507
"1486","10/3/1995",73,2,71,2.8169014084507
"1487","10/3/1996",68,2,66,3.03030303030303
"1488","10/3/1997",64,2,62,3.2258064516129
"1489","10/3/1998",60,1,59,1.69491525423729
"1490","10/3/1999",125,3,122,2.45901639344262
"1491","10/3/2000",74,1,73,1.36986301369863
"1492","10/3/2001",70,0,70,0
"1493","10/3/2002",70,1,69,1.44927536231884
"1494","10/3/2003",56,0,56,0
"1495","10/3/2004",120,6,114,5.26315789473684
"1496","10/3/2005",74,0,74,0
"1497","10/3/2006",72,1,71,1.40845070422535
"1498","10/3/2007",74,0,74,0
"1499","10/3/2008",67,3,64,4.6875
"1500","10/3/2009",61,1,60,1.66666666666667
"1501","10/3/2010",124,1,123,0.813008130081301
"1502","10/3/2011",73,1,72,1.38888888888889
"1503","10/3/2012",72,2,70,2.85714285714286
"1504","10/3/2013",72,4,68,5.88235294117647
"1505","10/3/2014",59,4,55,7.27272727272727
"1506","10/3/2015",62,4,58,6.89655172413793
"1507","10/3/2016",69,0,69,0
"1508","10/3/2017",70,2,68,2.94117647058824
"1509","10/3/2018",76,2,74,2.7027027027027
"1510","10/3/2019",74,2,72,2.77777777777778
"1511","10/3/2020",67,4,63,6.34920634920635
"1512","10/3/2021",140,2,138,1.44927536231884
"1513","10/30/1994",127,6,121,4.95867768595041
"1514","10/30/1995",76,0,76,0
"1515","10/30/1996",68,0,68,0
"1516","10/30/1997",67,1,66,1.51515151515152
"1517","10/30/1998",56,2,54,3.7037037037037
"1518","10/30/1999",60,2,58,3.44827586206897
"1519","10/30/2000",74,0,74,0
"1520","10/30/2001",74,1,73,1.36986301369863
"1521","10/30/2002",65,3,62,4.83870967741935
"1522","10/30/2003",67,1,66,1.51515151515152
"1523","10/30/2004",49,2,47,4.25531914893617
"1524","10/30/2005",124,1,123,0.813008130081301
"1525","10/30/2006",70,0,70,0
"1526","10/30/2007",72,1,71,1.40845070422535
"1527","10/30/2008",71,2,69,2.89855072463768
"1528","10/30/2009",62,2,60,3.33333333333333
"1529","10/30/2010",63,3,60,5
"1530","10/30/2011",129,4,125,3.2
"1531","10/30/2012",76,2,74,2.7027027027027
"1532","10/30/2013",67,8,59,13.5593220338983
"1533","10/30/2014",70,6,64,9.375
"1534","10/30/2015",60,4,56,7.14285714285714
"1535","10/30/2016",125,3,122,2.45901639344262
"1536","10/30/2017",74,3,71,4.22535211267606
"1537","10/30/2018",68,3,65,4.61538461538462
"1538","10/30/2019",77,1,76,1.31578947368421
"1539","10/30/2020",66,2,64,3.125
"1540","10/30/2021",64,5,59,8.47457627118644
"1541","10/31/1994",74,1,73,1.36986301369863
"1542","10/31/1995",68,1,67,1.49253731343284
"1543","10/31/1996",69,0,69,0
"1544","10/31/1997",60,2,58,3.44827586206897
"1545","10/31/1998",62,2,60,3.33333333333333
"1546","10/31/1999",142,7,135,5.18518518518519
"1547","10/31/2000",74,1,73,1.36986301369863
"1548","10/31/2001",75,5,70,7.14285714285714
"1549","10/31/2002",75,3,72,4.16666666666667
"1550","10/31/2003",74,2,72,2.77777777777778
"1551","10/31/2004",128,7,121,5.78512396694215
"1552","10/31/2005",74,1,73,1.36986301369863
"1553","10/31/2006",71,5,66,7.57575757575758
"1554","10/31/2007",75,0,75,0
"1555","10/31/2008",64,3,61,4.91803278688525
"1556","10/31/2009",49,3,46,6.52173913043478
"1557","10/31/2010",134,7,127,5.51181102362205
"1558","10/31/2011",75,1,74,1.35135135135135
"1559","10/31/2012",73,0,73,0
"1560","10/31/2013",75,2,73,2.73972602739726
"1561","10/31/2014",57,3,54,5.55555555555556
"1562","10/31/2015",60,3,57,5.26315789473684
"1563","10/31/2016",72,0,72,0
"1564","10/31/2017",71,4,67,5.97014925373134
"1565","10/31/2018",72,1,71,1.40845070422535
"1566","10/31/2019",71,2,69,2.89855072463768
"1567","10/31/2020",65,2,63,3.17460317460317
"1568","10/31/2021",130,8,122,6.55737704918033
"1569","10/4/1994",70,0,70,0
"1570","10/4/1995",70,0,70,0
"1571","10/4/1996",63,5,58,8.62068965517241
"1572","10/4/1997",61,0,61,0
"1573","10/4/1998",118,3,115,2.60869565217391
"1574","10/4/1999",77,1,76,1.31578947368421
"1575","10/4/2000",70,3,67,4.47761194029851
"1576","10/4/2001",66,5,61,8.19672131147541
"1577","10/4/2002",63,1,62,1.61290322580645
"1578","10/4/2003",67,3,64,4.6875
"1579","10/4/2004",71,0,71,0
"1580","10/4/2005",74,0,74,0
"1581","10/4/2006",71,5,66,7.57575757575758
"1582","10/4/2007",69,2,67,2.98507462686567
"1583","10/4/2008",61,6,55,10.9090909090909
"1584","10/4/2009",127,5,122,4.0983606557377
"1585","10/4/2010",75,1,74,1.35135135135135
"1586","10/4/2011",74,1,73,1.36986301369863
"1587","10/4/2012",74,4,70,5.71428571428571
"1588","10/4/2013",70,10,60,16.6666666666667
"1589","10/4/2014",61,6,55,10.9090909090909
"1590","10/4/2015",127,10,117,8.54700854700855
"1591","10/4/2016",73,1,72,1.38888888888889
"1592","10/4/2017",72,3,69,4.34782608695652
"1593","10/4/2018",71,5,66,7.57575757575758
"1594","10/4/2019",57,1,56,1.78571428571429
"1595","10/4/2020",117,3,114,2.63157894736842
"1596","10/4/2021",74,2,72,2.77777777777778
"1597","10/5/1994",73,0,73,0
"1598","10/5/1995",65,3,62,4.83870967741935
"1599","10/5/1996",58,2,56,3.57142857142857
"1600","10/5/1997",135,0,135,0
"1601","10/5/1998",73,0,73,0
"1602","10/5/1999",73,0,73,0
"1603","10/5/2000",73,3,70,4.28571428571429
"1604","10/5/2001",62,4,58,6.89655172413793
"1605","10/5/2002",68,2,66,3.03030303030303
"1606","10/5/2003",133,6,127,4.7244094488189
"1607","10/5/2004",74,0,74,0
"1608","10/5/2005",68,1,67,1.49253731343284
"1609","10/5/2006",71,2,69,2.89855072463768
"1610","10/5/2007",57,5,52,9.61538461538462
"1611","10/5/2008",125,7,118,5.93220338983051
"1612","10/5/2009",70,2,68,2.94117647058824
"1613","10/5/2010",73,1,72,1.38888888888889
"1614","10/5/2011",75,1,74,1.35135135135135
"1615","10/5/2012",57,6,51,11.7647058823529
"1616","10/5/2013",60,9,51,17.6470588235294
"1617","10/5/2014",127,6,121,4.95867768595041
"1618","10/5/2015",73,0,73,0
"1619","10/5/2016",69,2,67,2.98507462686567
"1620","10/5/2017",66,3,63,4.76190476190476
"1621","10/5/2018",61,2,59,3.38983050847458
"1622","10/5/2019",65,2,63,3.17460317460317
"1623","10/5/2020",75,0,75,0
"1624","10/5/2021",72,3,69,4.34782608695652
"1625","10/6/1994",72,5,67,7.46268656716418
"1626","10/6/1995",68,0,68,0
"1627","10/6/1996",128,1,127,0.78740157480315
"1628","10/6/1997",71,0,71,0
"1629","10/6/1998",71,0,71,0
"1630","10/6/1999",67,1,66,1.51515151515152
"1631","10/6/2000",68,6,62,9.67741935483871
"1632","10/6/2001",63,1,62,1.61290322580645
"1633","10/6/2002",126,2,124,1.61290322580645
"1634","10/6/2003",76,0,76,0
"1635","10/6/2004",73,4,69,5.79710144927536
"1636","10/6/2005",69,3,66,4.54545454545455
"1637","10/6/2006",63,3,60,5
"1638","10/6/2007",62,3,59,5.08474576271187
"1639","10/6/2008",77,1,76,1.31578947368421
"1640","10/6/2009",70,1,69,1.44927536231884
"1641","10/6/2010",69,0,69,0
"1642","10/6/2011",72,4,68,5.88235294117647
"1643","10/6/2012",61,6,55,10.9090909090909
"1644","10/6/2013",121,2,119,1.68067226890756
"1645","10/6/2014",72,2,70,2.85714285714286
"1646","10/6/2015",72,2,70,2.85714285714286
"1647","10/6/2016",65,2,63,3.17460317460317
"1648","10/6/2017",55,0,55,0
"1649","10/6/2018",54,3,51,5.88235294117647
"1650","10/6/2019",126,4,122,3.27868852459016
"1651","10/6/2020",71,2,69,2.89855072463768
"1652","10/6/2021",69,4,65,6.15384615384615
"1653","10/7/1994",71,6,65,9.23076923076923
"1654","10/7/1995",48,0,48,0
"1655","10/7/1996",75,0,75,0
"1656","10/7/1997",74,1,73,1.36986301369863
"1657","10/7/1998",74,0,74,0
"1658","10/7/1999",72,0,72,0
"1659","10/7/2000",59,4,55,7.27272727272727
"1660","10/7/2001",119,4,115,3.47826086956522
"1661","10/7/2002",78,1,77,1.2987012987013
"1662","10/7/2003",74,2,72,2.77777777777778
"1663","10/7/2004",69,3,66,4.54545454545455
"1664","10/7/2005",65,6,59,10.1694915254237
"1665","10/7/2006",63,3,60,5
"1666","10/7/2007",130,3,127,2.36220472440945
"1667","10/7/2008",72,0,72,0
"1668","10/7/2009",73,1,72,1.38888888888889
"1669","10/7/2010",69,2,67,2.98507462686567
"1670","10/7/2011",72,6,66,9.09090909090909
"1671","10/7/2012",126,9,117,7.69230769230769
"1672","10/7/2013",74,0,74,0
"1673","10/7/2014",77,1,76,1.31578947368421
"1674","10/7/2015",73,5,68,7.35294117647059
"1675","10/7/2016",64,5,59,8.47457627118644
"1676","10/7/2017",51,3,48,6.25
"1677","10/7/2018",128,3,125,2.4
"1678","10/7/2019",75,2,73,2.73972602739726
"1679","10/7/2020",71,3,68,4.41176470588235
"1680","10/7/2021",59,7,52,13.4615384615385
"1681","10/8/1994",61,1,60,1.66666666666667
"1682","10/8/1995",150,0,150,0
"1683","10/8/1996",69,0,69,0
"1684","10/8/1997",64,1,63,1.58730158730159
"1685","10/8/1998",68,2,66,3.03030303030303
"1686","10/8/1999",62,3,59,5.08474576271187
"1687","10/8/2000",129,3,126,2.38095238095238
"1688","10/8/2001",67,2,65,3.07692307692308
"1689","10/8/2002",74,2,72,2.77777777777778
"1690","10/8/2003",76,3,73,4.10958904109589
"1691","10/8/2004",62,2,60,3.33333333333333
"1692","10/8/2005",45,5,40,12.5
"1693","10/8/2006",123,0,123,0
"1694","10/8/2007",76,3,73,4.10958904109589
"1695","10/8/2008",69,0,69,0
"1696","10/8/2009",72,1,71,1.40845070422535
"1697","10/8/2010",52,4,48,8.33333333333333
"1698","10/8/2011",60,4,56,7.14285714285714
"1699","10/8/2012",75,2,73,2.73972602739726
"1700","10/8/2013",76,1,75,1.33333333333333
"1701","10/8/2014",75,2,73,2.73972602739726
"1702","10/8/2015",67,3,64,4.6875
"1703","10/8/2016",59,4,55,7.27272727272727
"1704","10/8/2017",127,14,113,12.3893805309735
"1705","10/8/2018",76,2,74,2.7027027027027
"1706","10/8/2019",75,1,74,1.35135135135135
"1707","10/8/2020",65,5,60,8.33333333333333
"1708","10/8/2021",65,3,62,4.83870967741935
"1709","10/9/1994",135,2,133,1.50375939849624
"1710","10/9/1995",77,1,76,1.31578947368421
"1711","10/9/1996",73,0,73,0
"1712","10/9/1997",66,1,65,1.53846153846154
"1713","10/9/1998",67,2,65,3.07692307692308
"1714","10/9/1999",59,1,58,1.72413793103448
"1715","10/9/2000",73,0,73,0
"1716","10/9/2001",74,2,72,2.77777777777778
"1717","10/9/2002",71,3,68,4.41176470588235
"1718","10/9/2003",69,1,68,1.47058823529412
"1719","10/9/2004",44,2,42,4.76190476190476
"1720","10/9/2005",131,2,129,1.55038759689922
"1721","10/9/2006",74,1,73,1.36986301369863
"1722","10/9/2007",71,0,71,0
"1723","10/9/2008",67,1,66,1.51515151515152
"1724","10/9/2009",66,4,62,6.45161290322581
"1725","10/9/2010",52,4,48,8.33333333333333
"1726","10/9/2011",125,5,120,4.16666666666667
"1727","10/9/2012",71,1,70,1.42857142857143
"1728","10/9/2013",69,1,68,1.47058823529412
"1729","10/9/2014",70,5,65,7.69230769230769
"1730","10/9/2015",62,3,59,5.08474576271187
"1731","10/9/2016",130,2,128,1.5625
"1732","10/9/2017",71,1,70,1.42857142857143
"1733","10/9/2018",65,3,62,4.83870967741935
"1734","10/9/2019",70,3,67,4.47761194029851
"1735","10/9/2020",62,2,60,3.33333333333333
"1736","10/9/2021",67,4,63,6.34920634920635
"1737","11/1/1994",72,1,71,1.40845070422535
"1738","11/1/1995",68,0,68,0
"1739","11/1/1996",59,1,58,1.72413793103448
"1740","11/1/1997",64,3,61,4.91803278688525
"1741","11/1/1998",127,4,123,3.2520325203252
"1742","11/1/1999",70,0,70,0
"1743","11/1/2000",76,3,73,4.10958904109589
"1744","11/1/2001",65,3,62,4.83870967741935
"1745","11/1/2002",52,1,51,1.96078431372549
"1746","11/1/2003",61,7,54,12.962962962963
"1747","11/1/2004",76,0,76,0
"1748","11/1/2005",73,2,71,2.8169014084507
"1749","11/1/2006",75,4,71,5.63380281690141
"1750","11/1/2007",62,1,61,1.63934426229508
"1751","11/1/2008",71,4,67,5.97014925373134
"1752","11/1/2009",114,0,114,0
"1753","11/1/2010",74,0,74,0
"1754","11/1/2011",72,0,72,0
"1755","11/1/2012",66,7,59,11.864406779661
"1756","11/1/2013",63,1,62,1.61290322580645
"1757","11/1/2014",93,10,83,12.0481927710843
"1758","11/1/2015",126,5,121,4.13223140495868
"1759","11/1/2016",65,1,64,1.5625
"1760","11/1/2017",72,2,70,2.85714285714286
"1761","11/1/2018",64,6,58,10.3448275862069
"1762","11/1/2019",66,3,63,4.76190476190476
"1763","11/1/2020",128,10,118,8.47457627118644
"1764","11/10/1994",69,2,67,2.98507462686567
"1765","11/10/1995",71,1,70,1.42857142857143
"1766","11/10/1996",128,3,125,2.4
"1767","11/10/1997",73,0,73,0
"1768","11/10/1998",69,0,69,0
"1769","11/10/1999",72,1,71,1.40845070422535
"1770","11/10/2000",63,5,58,8.62068965517241
"1771","11/10/2001",67,6,61,9.83606557377049
"1772","11/10/2002",132,9,123,7.31707317073171
"1773","11/10/2003",69,0,69,0
"1774","11/10/2004",73,2,71,2.8169014084507
"1775","11/10/2005",64,3,61,4.91803278688525
"1776","11/10/2006",61,5,56,8.92857142857143
"1777","11/10/2007",63,3,60,5
"1778","11/10/2008",76,0,76,0
"1779","11/10/2009",72,0,72,0
"1780","11/10/2010",68,0,68,0
"1781","11/10/2011",66,4,62,6.45161290322581
"1782","11/10/2012",64,4,60,6.66666666666667
"1783","11/10/2013",124,3,121,2.47933884297521
"1784","11/10/2014",75,0,75,0
"1785","11/10/2015",70,1,69,1.44927536231884
"1786","11/10/2016",69,4,65,6.15384615384615
"1787","11/10/2017",59,5,54,9.25925925925926
"1788","11/10/2018",61,3,58,5.17241379310345
"1789","11/10/2019",124,4,120,3.33333333333333
"1790","11/10/2020",72,1,71,1.40845070422535
"1791","11/11/1994",55,1,54,1.85185185185185
"1792","11/11/1995",58,0,58,0
"1793","11/11/1996",75,0,75,0
"1794","11/11/1997",70,0,70,0
"1795","11/11/1998",69,2,67,2.98507462686567
"1796","11/11/1999",68,4,64,6.25
"1797","11/11/2000",50,0,50,0
"1798","11/11/2001",120,6,114,5.26315789473684
"1799","11/11/2002",73,0,73,0
"1800","11/11/2003",68,0,68,0
"1801","11/11/2004",70,2,68,2.94117647058824
"1802","11/11/2005",67,3,64,4.6875
"1803","11/11/2006",58,3,55,5.45454545454545
"1804","11/11/2007",127,5,122,4.0983606557377
"1805","11/11/2008",75,0,75,0
"1806","11/11/2009",73,1,72,1.38888888888889
"1807","11/11/2010",67,2,65,3.07692307692308
"1808","11/11/2011",61,4,57,7.01754385964912
"1809","11/11/2012",123,4,119,3.36134453781513
"1810","11/11/2013",69,0,69,0
"1811","11/11/2014",68,2,66,3.03030303030303
"1812","11/11/2015",75,0,75,0
"1813","11/11/2016",69,5,64,7.8125
"1814","11/11/2017",64,3,61,4.91803278688525
"1815","11/11/2018",132,2,130,1.53846153846154
"1816","11/11/2019",76,2,74,2.7027027027027
"1817","11/11/2020",71,0,71,0
"1818","11/12/1994",58,0,58,0
"1819","11/12/1995",124,1,123,0.813008130081301
"1820","11/12/1996",72,3,69,4.34782608695652
"1821","11/12/1997",74,1,73,1.36986301369863
"1822","11/12/1998",64,4,60,6.66666666666667
"1823","11/12/1999",61,8,53,15.0943396226415
"1824","11/12/2000",122,12,110,10.9090909090909
"1825","11/12/2001",74,0,74,0
"1826","11/12/2002",68,3,65,4.61538461538462
"1827","11/12/2003",75,1,74,1.35135135135135
"1828","11/12/2004",65,2,63,3.17460317460317
"1829","11/12/2005",63,3,60,5
"1830","11/12/2006",128,5,123,4.0650406504065
"1831","11/12/2007",70,0,70,0
"1832","11/12/2008",71,3,68,4.41176470588235
"1833","11/12/2009",70,3,67,4.47761194029851
"1834","11/12/2010",67,8,59,13.5593220338983
"1835","11/12/2011",62,5,57,8.7719298245614
"1836","11/12/2012",74,0,74,0
"1837","11/12/2013",73,2,71,2.8169014084507
"1838","11/12/2014",74,2,72,2.77777777777778
"1839","11/12/2015",64,3,61,4.91803278688525
"1840","11/12/2016",59,7,52,13.4615384615385
"1841","11/12/2017",125,3,122,2.45901639344262
"1842","11/12/2018",72,1,71,1.40845070422535
"1843","11/12/2019",63,1,62,1.61290322580645
"1844","11/12/2020",68,4,64,6.25
"1845","11/13/1994",124,4,120,3.33333333333333
"1846","11/13/1995",74,0,74,0
"1847","11/13/1996",71,1,70,1.42857142857143
"1848","11/13/1997",67,1,66,1.51515151515152
"1849","11/13/1998",60,2,58,3.44827586206897
"1850","11/13/1999",63,1,62,1.61290322580645
"1851","11/13/2000",72,2,70,2.85714285714286
"1852","11/13/2001",69,0,69,0
"1853","11/13/2002",73,3,70,4.28571428571429
"1854","11/13/2003",63,1,62,1.61290322580645
"1855","11/13/2004",38,0,38,0
"1856","11/13/2005",127,3,124,2.41935483870968
"1857","11/13/2006",67,0,67,0
"1858","11/13/2007",72,2,70,2.85714285714286
"1859","11/13/2008",68,1,67,1.49253731343284
"1860","11/13/2009",67,7,60,11.6666666666667
"1861","11/13/2010",50,4,46,8.69565217391304
"1862","11/13/2011",123,5,118,4.23728813559322
"1863","11/13/2012",72,3,69,4.34782608695652
"1864","11/13/2013",65,1,64,1.5625
"1865","11/13/2014",76,2,74,2.7027027027027
"1866","11/13/2015",59,2,57,3.50877192982456
"1867","11/13/2016",117,4,113,3.53982300884956
"1868","11/13/2017",72,1,71,1.40845070422535
"1869","11/13/2018",69,1,68,1.47058823529412
"1870","11/13/2019",72,0,72,0
"1871","11/13/2020",68,1,67,1.49253731343284
"1872","11/14/1994",76,0,76,0
"1873","11/14/1995",72,0,72,0
"1874","11/14/1996",74,3,71,4.22535211267606
"1875","11/14/1997",61,4,57,7.01754385964912
"1876","11/14/1998",72,0,72,0
"1877","11/14/1999",122,4,118,3.38983050847458
"1878","11/14/2000",73,2,71,2.8169014084507
"1879","11/14/2001",68,3,65,4.61538461538462
"1880","11/14/2002",70,1,69,1.44927536231884
"1881","11/14/2003",61,3,58,5.17241379310345
"1882","11/14/2004",128,1,127,0.78740157480315
"1883","11/14/2005",70,0,70,0
"1884","11/14/2006",73,1,72,1.38888888888889
"1885","11/14/2007",72,0,72,0
"1886","11/14/2008",64,3,61,4.91803278688525
"1887","11/14/2009",68,3,65,4.61538461538462
"1888","11/14/2010",123,6,117,5.12820512820513
"1889","11/14/2011",71,0,71,0
"1890","11/14/2012",68,2,66,3.03030303030303
"1891","11/14/2013",71,2,69,2.89855072463768
"1892","11/14/2014",53,4,49,8.16326530612245
"1893","11/14/2015",57,3,54,5.55555555555556
"1894","11/14/2016",73,0,73,0
"1895","11/14/2017",74,2,72,2.77777777777778
"1896","11/14/2018",59,1,58,1.72413793103448
"1897","11/14/2019",71,5,66,7.57575757575758
"1898","11/14/2020",63,8,55,14.5454545454545
"1899","11/15/1994",64,2,62,3.2258064516129
"1900","11/15/1995",67,0,67,0
"1901","11/15/1996",59,1,58,1.72413793103448
"1902","11/15/1997",60,1,59,1.69491525423729
"1903","11/15/1998",117,3,114,2.63157894736842
"1904","11/15/1999",70,1,69,1.44927536231884
"1905","11/15/2000",71,0,71,0
"1906","11/15/2001",68,2,66,3.03030303030303
"1907","11/15/2002",66,1,65,1.53846153846154
"1908","11/15/2003",59,2,57,3.50877192982456
"1909","11/15/2004",76,0,76,0
"1910","11/15/2005",73,1,72,1.38888888888889
"1911","11/15/2006",74,2,72,2.77777777777778
"1912","11/15/2007",69,2,67,2.98507462686567
"1913","11/15/2008",59,4,55,7.27272727272727
"1914","11/15/2009",128,2,126,1.58730158730159
"1915","11/15/2010",76,1,75,1.33333333333333
"1916","11/15/2011",72,2,70,2.85714285714286
"1917","11/15/2012",76,4,72,5.55555555555556
"1918","11/15/2013",56,2,54,3.7037037037037
"1919","11/15/2014",60,7,53,13.2075471698113
"1920","11/15/2015",122,5,117,4.27350427350427
"1921","11/15/2016",70,0,70,0
"1922","11/15/2017",72,4,68,5.88235294117647
"1923","11/15/2018",74,4,70,5.71428571428571
"1924","11/15/2019",68,1,67,1.49253731343284
"1925","11/15/2020",120,8,112,7.14285714285714
"1926","11/16/1994",61,0,61,0
"1927","11/16/1995",68,0,68,0
"1928","11/16/1996",67,0,67,0
"1929","11/16/1997",121,2,119,1.68067226890756
"1930","11/16/1998",73,1,72,1.38888888888889
"1931","11/16/1999",77,0,77,0
"1932","11/16/2000",69,1,68,1.47058823529412
"1933","11/16/2001",63,6,57,10.5263157894737
"1934","11/16/2002",59,3,56,5.35714285714286
"1935","11/16/2003",129,3,126,2.38095238095238
"1936","11/16/2004",75,0,75,0
"1937","11/16/2005",72,2,70,2.85714285714286
"1938","11/16/2006",71,3,68,4.41176470588235
"1939","11/16/2007",66,4,62,6.45161290322581
"1940","11/16/2008",126,6,120,5
"1941","11/16/2009",76,0,76,0
"1942","11/16/2010",78,0,78,0
"1943","11/16/2011",75,3,72,4.16666666666667
"1944","11/16/2012",63,6,57,10.5263157894737
"1945","11/16/2013",64,6,58,10.3448275862069
"1946","11/16/2014",128,8,120,6.66666666666667
"1947","11/16/2015",73,1,72,1.38888888888889
"1948","11/16/2016",74,0,74,0
"1949","11/16/2017",72,4,68,5.88235294117647
"1950","11/16/2018",66,2,64,3.125
"1951","11/16/2019",67,1,66,1.51515151515152
"1952","11/16/2020",75,1,74,1.35135135135135
"1953","11/17/1994",62,0,62,0
"1954","11/17/1995",58,2,56,3.57142857142857
"1955","11/17/1996",127,1,126,0.793650793650794
"1956","11/17/1997",69,1,68,1.47058823529412
"1957","11/17/1998",76,0,76,0
"1958","11/17/1999",73,1,72,1.38888888888889
"1959","11/17/2000",58,1,57,1.75438596491228
"1960","11/17/2001",62,5,57,8.7719298245614
"1961","11/17/2002",124,4,120,3.33333333333333
"1962","11/17/2003",76,0,76,0
"1963","11/17/2004",73,1,72,1.38888888888889
"1964","11/17/2005",62,1,61,1.63934426229508
"1965","11/17/2006",68,8,60,13.3333333333333
"1966","11/17/2007",60,4,56,7.14285714285714
"1967","11/17/2008",72,0,72,0
"1968","11/17/2009",73,1,72,1.38888888888889
"1969","11/17/2010",76,1,75,1.33333333333333
"1970","11/17/2011",69,4,65,6.15384615384615
"1971","11/17/2012",55,4,51,7.84313725490196
"1972","11/17/2013",127,6,121,4.95867768595041
"1973","11/17/2014",73,2,71,2.8169014084507
"1974","11/17/2015",73,0,73,0
"1975","11/17/2016",53,4,49,8.16326530612245
"1976","11/17/2017",61,4,57,7.01754385964912
"1977","11/17/2018",60,4,56,7.14285714285714
"1978","11/17/2019",122,4,118,3.38983050847458
"1979","11/17/2020",73,2,71,2.8169014084507
"1980","11/18/1994",73,0,73,0
"1981","11/18/1995",69,3,66,4.54545454545455
"1982","11/18/1996",74,2,72,2.77777777777778
"1983","11/18/1997",71,1,70,1.42857142857143
"1984","11/18/1998",73,4,69,5.79710144927536
"1985","11/18/1999",72,0,72,0
"1986","11/18/2000",60,3,57,5.26315789473684
"1987","11/18/2001",124,5,119,4.20168067226891
"1988","11/18/2002",73,0,73,0
"1989","11/18/2003",75,2,73,2.73972602739726
"1990","11/18/2004",66,3,63,4.76190476190476
"1991","11/18/2005",55,3,52,5.76923076923077
"1992","11/18/2006",62,3,59,5.08474576271187
"1993","11/18/2007",122,1,121,0.826446280991736
"1994","11/18/2008",72,0,72,0
"1995","11/18/2009",70,1,69,1.44927536231884
"1996","11/18/2010",75,3,72,4.16666666666667
"1997","11/18/2011",57,3,54,5.55555555555556
"1998","11/18/2012",116,4,112,3.57142857142857
"1999","11/18/2013",70,0,70,0
"2000","11/18/2014",74,2,72,2.77777777777778
"2001","11/18/2015",73,2,71,2.8169014084507
"2002","11/18/2016",58,3,55,5.45454545454545
"2003","11/18/2017",60,6,54,11.1111111111111
"2004","11/18/2018",106,3,103,2.9126213592233
"2005","11/18/2019",69,0,69,0
"2006","11/18/2020",68,2,66,3.03030303030303
"2007","11/19/1994",53,2,51,3.92156862745098
"2008","11/19/1995",150,5,145,3.44827586206897
"2009","11/19/1996",76,0,76,0
"2010","11/19/1997",67,0,67,0
"2011","11/19/1998",66,3,63,4.76190476190476
"2012","11/19/1999",62,1,61,1.63934426229508
"2013","11/19/2000",124,4,120,3.33333333333333
"2014","11/19/2001",78,1,77,1.2987012987013
"2015","11/19/2002",70,0,70,0
"2016","11/19/2003",71,2,69,2.89855072463768
"2017","11/19/2004",69,3,66,4.54545454545455
"2018","11/19/2005",49,2,47,4.25531914893617
"2019","11/19/2006",131,4,127,3.1496062992126
"2020","11/19/2007",74,0,74,0
"2021","11/19/2008",75,6,69,8.69565217391304
"2022","11/19/2009",62,2,60,3.33333333333333
"2023","11/19/2010",64,6,58,10.3448275862069
"2024","11/19/2011",67,4,63,6.34920634920635
"2025","11/19/2012",74,1,73,1.36986301369863
"2026","11/19/2013",77,3,74,4.05405405405405
"2027","11/19/2014",74,3,71,4.22535211267606
"2028","11/19/2015",71,6,65,9.23076923076923
"2029","11/19/2016",65,1,64,1.5625
"2030","11/19/2017",126,8,118,6.77966101694915
"2031","11/19/2018",73,2,71,2.8169014084507
"2032","11/19/2019",68,0,68,0
"2033","11/19/2020",66,7,59,11.864406779661
"2034","11/2/1994",74,5,69,7.2463768115942
"2035","11/2/1995",68,0,68,0
"2036","11/2/1996",62,1,61,1.63934426229508
"2037","11/2/1997",124,2,122,1.63934426229508
"2038","11/2/1998",71,1,70,1.42857142857143
"2039","11/2/1999",71,0,71,0
"2040","11/2/2000",67,1,66,1.51515151515152
"2041","11/2/2001",70,4,66,6.06060606060606
"2042","11/2/2002",64,4,60,6.66666666666667
"2043","11/2/2003",125,7,118,5.93220338983051
"2044","11/2/2004",74,0,74,0
"2045","11/2/2005",75,1,74,1.35135135135135
"2046","11/2/2006",67,4,63,6.34920634920635
"2047","11/2/2007",64,4,60,6.66666666666667
"2048","11/2/2008",121,3,118,2.54237288135593
"2049","11/2/2009",73,0,73,0
"2050","11/2/2010",66,1,65,1.53846153846154
"2051","11/2/2011",70,1,69,1.44927536231884
"2052","11/2/2012",60,5,55,9.09090909090909
"2053","11/2/2013",68,5,63,7.93650793650794
"2054","11/2/2014",126,5,121,4.13223140495868
"2055","11/2/2015",74,2,72,2.77777777777778
"2056","11/2/2016",69,1,68,1.47058823529412
"2057","11/2/2017",73,1,72,1.38888888888889
"2058","11/2/2018",59,3,56,5.35714285714286
"2059","11/2/2019",62,5,57,8.7719298245614
"2060","11/2/2020",71,0,71,0
"2061","11/20/1994",128,2,126,1.58730158730159
"2062","11/20/1995",74,0,74,0
"2063","11/20/1996",71,2,69,2.89855072463768
"2064","11/20/1997",71,1,70,1.42857142857143
"2065","11/20/1998",60,3,57,5.26315789473684
"2066","11/20/1999",66,3,63,4.76190476190476
"2067","11/20/2000",75,3,72,4.16666666666667
"2068","11/20/2001",66,2,64,3.125
"2069","11/20/2002",73,2,71,2.8169014084507
"2070","11/20/2003",66,5,61,8.19672131147541
"2071","11/20/2004",59,2,57,3.50877192982456
"2072","11/20/2005",151,7,144,4.86111111111111
"2073","11/20/2006",73,0,73,0
"2074","11/20/2007",68,1,67,1.49253731343284
"2075","11/20/2008",64,1,63,1.58730158730159
"2076","11/20/2009",66,5,61,8.19672131147541
"2077","11/20/2010",56,4,52,7.69230769230769
"2078","11/20/2011",125,0,125,0
"2079","11/20/2012",69,1,68,1.47058823529412
"2080","11/20/2013",68,1,67,1.49253731343284
"2081","11/20/2014",67,3,64,4.6875
"2082","11/20/2015",61,7,54,12.962962962963
"2083","11/20/2016",130,4,126,3.17460317460317
"2084","11/20/2017",75,2,73,2.73972602739726
"2085","11/20/2018",73,0,73,0
"2086","11/20/2019",66,1,65,1.53846153846154
"2087","11/20/2020",61,3,58,5.17241379310345
"2088","11/21/1993",132,2,130,1.53846153846154
"2089","11/21/1994",74,0,74,0
"2090","11/21/1995",68,2,66,3.03030303030303
"2091","11/21/1996",65,5,60,8.33333333333333
"2092","11/21/1997",67,2,65,3.07692307692308
"2093","11/21/1998",64,6,58,10.3448275862069
"2094","11/21/1999",121,7,114,6.14035087719298
"2095","11/21/2000",75,1,74,1.35135135135135
"2096","11/21/2001",65,4,61,6.55737704918033
"2097","11/21/2002",71,5,66,7.57575757575758
"2098","11/21/2003",60,4,56,7.14285714285714
"2099","11/21/2004",131,1,130,0.769230769230769
"2100","11/21/2005",76,0,76,0
"2101","11/21/2006",70,2,68,2.94117647058824
"2102","11/21/2007",68,1,67,1.49253731343284
"2103","11/21/2008",51,2,49,4.08163265306122
"2104","11/21/2009",61,2,59,3.38983050847458
"2105","11/21/2010",127,1,126,0.793650793650794
"2106","11/21/2011",74,1,73,1.36986301369863
"2107","11/21/2012",77,1,76,1.31578947368421
"2108","11/21/2013",76,4,72,5.55555555555556
"2109","11/21/2014",68,6,62,9.67741935483871
"2110","11/21/2015",50,3,47,6.38297872340426
"2111","11/21/2016",72,0,72,0
"2112","11/21/2017",69,2,67,2.98507462686567
"2113","11/21/2018",74,5,69,7.2463768115942
"2114","11/21/2019",79,2,77,2.5974025974026
"2115","11/21/2020",59,3,56,5.35714285714286
"2116","11/22/1993",70,3,67,4.47761194029851
"2117","11/22/1994",70,0,70,0
"2118","11/22/1995",75,0,75,0
"2119","11/22/1996",70,2,68,2.94117647058824
"2120","11/22/1997",60,1,59,1.69491525423729
"2121","11/22/1998",120,2,118,1.69491525423729
"2122","11/22/1999",75,0,75,0
"2123","11/22/2000",73,1,72,1.38888888888889
"2124","11/22/2001",74,3,71,4.22535211267606
"2125","11/22/2002",62,9,53,16.9811320754717
"2126","11/22/2003",48,1,47,2.12765957446809
"2127","11/22/2004",74,0,74,0
"2128","11/22/2005",70,0,70,0
"2129","11/22/2006",71,0,71,0
"2130","11/22/2007",68,2,66,3.03030303030303
"2131","11/22/2008",50,5,45,11.1111111111111
"2132","11/22/2009",129,5,124,4.03225806451613
"2133","11/22/2010",72,1,71,1.40845070422535
"2134","11/22/2011",72,1,71,1.40845070422535
"2135","11/22/2012",73,7,66,10.6060606060606
"2136","11/22/2013",63,4,59,6.77966101694915
"2137","11/22/2014",64,4,60,6.66666666666667
"2138","11/22/2015",120,6,114,5.26315789473684
"2139","11/22/2016",71,1,70,1.42857142857143
"2140","11/22/2017",71,2,69,2.89855072463768
"2141","11/22/2018",68,2,66,3.03030303030303
"2142","11/22/2019",65,2,63,3.17460317460317
"2143","11/22/2020",133,4,129,3.10077519379845
"2144","11/23/1993",72,0,72,0
"2145","11/23/1994",73,1,72,1.38888888888889
"2146","11/23/1995",73,0,73,0
"2147","11/23/1996",66,4,62,6.45161290322581
"2148","11/23/1997",127,3,124,2.41935483870968
"2149","11/23/1998",74,0,74,0
"2150","11/23/1999",75,3,72,4.16666666666667
"2151","11/23/2000",66,1,65,1.53846153846154
"2152","11/23/2001",57,4,53,7.54716981132075
"2153","11/23/2002",65,1,64,1.5625
"2154","11/23/2003",131,2,129,1.55038759689922
"2155","11/23/2004",73,3,70,4.28571428571429
"2156","11/23/2005",74,4,70,5.71428571428571
"2157","11/23/2006",69,4,65,6.15384615384615
"2158","11/23/2007",59,1,58,1.72413793103448
"2159","11/23/2008",127,5,122,4.0983606557377
"2160","11/23/2009",76,2,74,2.7027027027027
"2161","11/23/2010",72,1,71,1.40845070422535
"2162","11/23/2011",70,0,70,0
"2163","11/23/2012",58,5,53,9.43396226415094
"2164","11/23/2013",70,3,67,4.47761194029851
"2165","11/23/2014",130,10,120,8.33333333333333
"2166","11/23/2015",74,1,73,1.36986301369863
"2167","11/23/2016",71,3,68,4.41176470588235
"2168","11/23/2017",70,3,67,4.47761194029851
"2169","11/23/2018",69,5,64,7.8125
"2170","11/23/2019",55,5,50,10
"2171","11/23/2020",70,0,70,0
"2172","11/24/1993",75,3,72,4.16666666666667
"2173","11/24/1994",67,2,65,3.07692307692308
"2174","11/24/1995",65,4,61,6.55737704918033
"2175","11/24/1996",123,2,121,1.65289256198347
"2176","11/24/1997",78,0,78,0
"2177","11/24/1998",69,1,68,1.47058823529412
"2178","11/24/1999",74,2,72,2.77777777777778
"2179","11/24/2000",66,4,62,6.45161290322581
"2180","11/24/2001",65,3,62,4.83870967741935
"2181","11/24/2002",128,8,120,6.66666666666667
"2182","11/24/2003",70,0,70,0
"2183","11/24/2004",74,1,73,1.36986301369863
"2184","11/24/2005",67,4,63,6.34920634920635
"2185","11/24/2006",60,0,60,0
"2186","11/24/2007",63,4,59,6.77966101694915
"2187","11/24/2008",72,1,71,1.40845070422535
"2188","11/24/2009",77,0,77,0
"2189","11/24/2010",76,0,76,0
"2190","11/24/2011",68,3,65,4.61538461538462
"2191","11/24/2012",61,8,53,15.0943396226415
"2192","11/24/2013",122,3,119,2.52100840336134
"2193","11/24/2014",75,1,74,1.35135135135135
"2194","11/24/2015",72,0,72,0
"2195","11/24/2016",74,1,73,1.36986301369863
"2196","11/24/2017",67,5,62,8.06451612903226
"2197","11/24/2018",62,3,59,5.08474576271187
"2198","11/24/2019",99,6,93,6.45161290322581
"2199","11/24/2020",78,3,75,4
"2200","11/25/1993",72,4,68,5.88235294117647
"2201","11/25/1994",64,2,62,3.2258064516129
"2202","11/25/1995",66,0,66,0
"2203","11/25/1996",75,0,75,0
"2204","11/25/1997",74,0,74,0
"2205","11/25/1998",73,1,72,1.38888888888889
"2206","11/25/1999",66,1,65,1.53846153846154
"2207","11/25/2000",59,2,57,3.50877192982456
"2208","11/25/2001",128,5,123,4.0650406504065
"2209","11/25/2002",78,0,78,0
"2210","11/25/2003",73,3,70,4.28571428571429
"2211","11/25/2004",73,1,72,1.38888888888889
"2212","11/25/2005",64,2,62,3.2258064516129
"2213","11/25/2006",64,5,59,8.47457627118644
"2214","11/25/2007",120,0,120,0
"2215","11/25/2008",71,0,71,0
"2216","11/25/2009",73,1,72,1.38888888888889
"2217","11/25/2010",68,0,68,0
"2218","11/25/2011",61,4,57,7.01754385964912
"2219","11/25/2012",128,3,125,2.4
"2220","11/25/2013",67,0,67,0
"2221","11/25/2014",73,1,72,1.38888888888889
"2222","11/25/2015",72,3,69,4.34782608695652
"2223","11/25/2016",59,4,55,7.27272727272727
"2224","11/25/2017",47,4,43,9.30232558139535
"2225","11/25/2018",131,10,121,8.26446280991736
"2226","11/25/2019",72,0,72,0
"2227","11/25/2020",68,1,67,1.49253731343284
"2228","11/26/1993",75,1,74,1.35135135135135
"2229","11/26/1994",62,1,61,1.63934426229508
"2230","11/26/1995",129,4,125,3.2
"2231","11/26/1996",70,0,70,0
"2232","11/26/1997",70,0,70,0
"2233","11/26/1998",65,0,65,0
"2234","11/26/1999",62,4,58,6.89655172413793
"2235","11/26/2000",119,4,115,3.47826086956522
"2236","11/26/2001",77,1,76,1.31578947368421
"2237","11/26/2002",67,1,66,1.51515151515152
"2238","11/26/2003",73,1,72,1.38888888888889
"2239","11/26/2004",64,3,61,4.91803278688525
"2240","11/26/2005",59,5,54,9.25925925925926
"2241","11/26/2006",131,4,127,3.1496062992126
"2242","11/26/2007",74,0,74,0
"2243","11/26/2008",67,2,65,3.07692307692308
"2244","11/26/2009",71,1,70,1.42857142857143
"2245","11/26/2010",66,5,61,8.19672131147541
"2246","11/26/2011",58,3,55,5.45454545454545
"2247","11/26/2012",75,0,75,0
"2248","11/26/2013",72,3,69,4.34782608695652
"2249","11/26/2014",71,4,67,5.97014925373134
"2250","11/26/2015",75,2,73,2.73972602739726
"2251","11/26/2016",52,4,48,8.33333333333333
"2252","11/26/2017",123,2,121,1.65289256198347
"2253","11/26/2018",70,0,70,0
"2254","11/26/2019",72,5,67,7.46268656716418
"2255","11/26/2020",77,1,76,1.31578947368421
"2256","11/27/1993",66,5,61,8.19672131147541
"2257","11/27/1994",126,3,123,2.4390243902439
"2258","11/27/1995",73,0,73,0
"2259","11/27/1996",69,1,68,1.47058823529412
"2260","11/27/1997",72,5,67,7.46268656716418
"2261","11/27/1998",60,2,58,3.44827586206897
"2262","11/27/1999",59,2,57,3.50877192982456
"2263","11/27/2000",71,0,71,0
"2264","11/27/2001",72,2,70,2.85714285714286
"2265","11/27/2002",70,4,66,6.06060606060606
"2266","11/27/2003",68,1,67,1.49253731343284
"2267","11/27/2004",50,3,47,6.38297872340426
"2268","11/27/2005",129,1,128,0.78125
"2269","11/27/2006",71,0,71,0
"2270","11/27/2007",72,3,69,4.34782608695652
"2271","11/27/2008",70,3,67,4.47761194029851
"2272","11/27/2009",68,0,68,0
"2273","11/27/2010",65,6,59,10.1694915254237
"2274","11/27/2011",131,4,127,3.1496062992126
"2275","11/27/2012",70,1,69,1.44927536231884
"2276","11/27/2013",72,2,70,2.85714285714286
"2277","11/27/2014",65,1,64,1.5625
"2278","11/27/2015",63,4,59,6.77966101694915
"2279","11/27/2016",128,9,119,7.56302521008403
"2280","11/27/2017",76,0,76,0
"2281","11/27/2018",70,2,68,2.94117647058824
"2282","11/27/2019",67,2,65,3.07692307692308
"2283","11/27/2020",65,5,60,8.33333333333333
"2284","11/28/1993",118,1,117,0.854700854700855
"2285","11/28/1994",71,0,71,0
"2286","11/28/1995",74,1,73,1.36986301369863
"2287","11/28/1996",68,3,65,4.61538461538462
"2288","11/28/1997",62,2,60,3.33333333333333
"2289","11/28/1998",67,3,64,4.6875
"2290","11/28/1999",126,2,124,1.61290322580645
"2291","11/28/2000",74,3,71,4.22535211267606
"2292","11/28/2001",73,2,71,2.8169014084507
"2293","11/28/2002",70,4,66,6.06060606060606
"2294","11/28/2003",60,1,59,1.69491525423729
"2295","11/28/2004",128,4,124,3.2258064516129
"2296","11/28/2005",73,1,72,1.38888888888889
"2297","11/28/2006",73,0,73,0
"2298","11/28/2007",72,3,69,4.34782608695652
"2299","11/28/2008",67,2,65,3.07692307692308
"2300","11/28/2009",61,2,59,3.38983050847458
"2301","11/28/2010",149,10,139,7.19424460431655
"2302","11/28/2011",71,0,71,0
"2303","11/28/2012",75,2,73,2.73972602739726
"2304","11/28/2013",72,4,68,5.88235294117647
"2305","11/28/2014",72,4,68,5.88235294117647
"2306","11/28/2015",64,5,59,8.47457627118644
"2307","11/28/2016",72,0,72,0
"2308","11/28/2017",74,1,73,1.36986301369863
"2309","11/28/2018",83,2,81,2.46913580246914
"2310","11/28/2019",68,3,65,4.61538461538462
"2311","11/28/2020",64,7,57,12.280701754386
"2312","11/29/1993",78,1,77,1.2987012987013
"2313","11/29/1994",72,3,69,4.34782608695652
"2314","11/29/1995",73,3,70,4.28571428571429
"2315","11/29/1996",70,4,66,6.06060606060606
"2316","11/29/1997",62,1,61,1.63934426229508
"2317","11/29/1998",118,1,117,0.854700854700855
"2318","11/29/1999",74,0,74,0
"2319","11/29/2000",75,2,73,2.73972602739726
"2320","11/29/2001",64,3,61,4.91803278688525
"2321","11/29/2002",59,5,54,9.25925925925926
"2322","11/29/2003",60,0,60,0
"2323","11/29/2004",76,0,76,0
"2324","11/29/2005",73,1,72,1.38888888888889
"2325","11/29/2006",76,2,74,2.7027027027027
"2326","11/29/2007",69,4,65,6.15384615384615
"2327","11/29/2008",63,2,61,3.27868852459016
"2328","11/29/2009",132,5,127,3.93700787401575
"2329","11/29/2010",70,0,70,0
"2330","11/29/2011",71,1,70,1.42857142857143
"2331","11/29/2012",67,3,64,4.6875
"2332","11/29/2013",68,8,60,13.3333333333333
"2333","11/29/2014",50,2,48,4.16666666666667
"2334","11/29/2015",126,5,121,4.13223140495868
"2335","11/29/2016",75,2,73,2.73972602739726
"2336","11/29/2017",75,3,72,4.16666666666667
"2337","11/29/2018",59,1,58,1.72413793103448
"2338","11/29/2019",62,1,61,1.63934426229508
"2339","11/29/2020",126,6,120,5
"2340","11/3/1994",69,1,68,1.47058823529412
"2341","11/3/1995",63,0,63,0
"2342","11/3/1996",153,5,148,3.37837837837838
"2343","11/3/1997",73,0,73,0
"2344","11/3/1998",71,1,70,1.42857142857143
"2345","11/3/1999",69,2,67,2.98507462686567
"2346","11/3/2000",66,10,56,17.8571428571429
"2347","11/3/2001",57,2,55,3.63636363636364
"2348","11/3/2002",120,7,113,6.19469026548673
"2349","11/3/2003",76,0,76,0
"2350","11/3/2004",70,1,69,1.44927536231884
"2351","11/3/2005",59,2,57,3.50877192982456
"2352","11/3/2006",57,2,55,3.63636363636364
"2353","11/3/2007",65,3,62,4.83870967741935
"2354","11/3/2008",74,0,74,0
"2355","11/3/2009",74,0,74,0
"2356","11/3/2010",72,1,71,1.40845070422535
"2357","11/3/2011",67,4,63,6.34920634920635
"2358","11/3/2012",55,4,51,7.84313725490196
"2359","11/3/2013",125,6,119,5.04201680672269
"2360","11/3/2014",74,1,73,1.36986301369863
"2361","11/3/2015",78,2,76,2.63157894736842
"2362","11/3/2016",74,3,71,4.22535211267606
"2363","11/3/2017",63,3,60,5
"2364","11/3/2018",57,3,54,5.55555555555556
"2365","11/3/2019",126,0,126,0
"2366","11/3/2020",75,1,74,1.35135135135135
"2367","11/30/1993",72,0,72,0
"2368","11/30/1994",69,1,68,1.47058823529412
"2369","11/30/1995",63,0,63,0
"2370","11/30/1996",63,0,63,0
"2371","11/30/1997",118,5,113,4.42477876106195
"2372","11/30/1998",71,0,71,0
"2373","11/30/1999",74,1,73,1.36986301369863
"2374","11/30/2000",66,3,63,4.76190476190476
"2375","11/30/2001",66,5,61,8.19672131147541
"2376","11/30/2002",64,3,61,4.91803278688525
"2377","11/30/2003",119,5,114,4.3859649122807
"2378","11/30/2004",74,2,72,2.77777777777778
"2379","11/30/2005",75,4,71,5.63380281690141
"2380","11/30/2006",68,1,67,1.49253731343284
"2381","11/30/2007",55,3,52,5.76923076923077
"2382","11/30/2008",127,2,125,1.6
"2383","11/30/2009",71,0,71,0
"2384","11/30/2010",75,0,75,0
"2385","11/30/2011",73,2,71,2.8169014084507
"2386","11/30/2012",65,4,61,6.55737704918033
"2387","11/30/2013",58,4,54,7.40740740740741
"2388","11/30/2014",124,11,113,9.73451327433628
"2389","11/30/2015",73,2,71,2.8169014084507
"2390","11/30/2016",72,4,68,5.88235294117647
"2391","11/30/2017",74,4,70,5.71428571428571
"2392","11/30/2018",60,3,57,5.26315789473684
"2393","11/30/2019",61,5,56,8.92857142857143
"2394","11/30/2020",74,1,73,1.36986301369863
"2395","11/4/1994",57,2,55,3.63636363636364
"2396","11/4/1995",56,0,56,0
"2397","11/4/1996",70,0,70,0
"2398","11/4/1997",70,0,70,0
"2399","11/4/1998",72,3,69,4.34782608695652
"2400","11/4/1999",65,1,64,1.5625
"2401","11/4/2000",60,0,60,0
"2402","11/4/2001",127,2,125,1.6
"2403","11/4/2002",77,3,74,4.05405405405405
"2404","11/4/2003",74,2,72,2.77777777777778
"2405","11/4/2004",68,3,65,4.61538461538462
"2406","11/4/2005",62,2,60,3.33333333333333
"2407","11/4/2006",62,3,59,5.08474576271187
"2408","11/4/2007",127,12,115,10.4347826086957
"2409","11/4/2008",70,2,68,2.94117647058824
"2410","11/4/2009",69,1,68,1.47058823529412
"2411","11/4/2010",72,6,66,9.09090909090909
"2412","11/4/2011",59,3,56,5.35714285714286
"2413","11/4/2012",123,6,117,5.12820512820513
"2414","11/4/2013",75,1,74,1.35135135135135
"2415","11/4/2014",71,5,66,7.57575757575758
"2416","11/4/2015",72,1,71,1.40845070422535
"2417","11/4/2016",59,4,55,7.27272727272727
"2418","11/4/2017",66,2,64,3.125
"2419","11/4/2018",111,11,100,11
"2420","11/4/2019",76,0,76,0
"2421","11/4/2020",72,2,70,2.85714285714286
"2422","11/5/1994",65,1,64,1.5625
"2423","11/5/1995",120,3,117,2.56410256410256
"2424","11/5/1996",74,0,74,0
"2425","11/5/1997",72,0,72,0
"2426","11/5/1998",67,1,66,1.51515151515152
"2427","11/5/1999",58,3,55,5.45454545454545
"2428","11/5/2000",134,7,127,5.51181102362205
"2429","11/5/2001",75,0,75,0
"2430","11/5/2002",75,0,75,0
"2431","11/5/2003",73,1,72,1.38888888888889
"2432","11/5/2004",56,3,53,5.66037735849057
"2433","11/5/2005",57,1,56,1.78571428571429
"2434","11/5/2006",157,1,156,0.641025641025641
"2435","11/5/2007",76,1,75,1.33333333333333
"2436","11/5/2008",72,0,72,0
"2437","11/5/2009",73,1,72,1.38888888888889
"2438","11/5/2010",63,9,54,16.6666666666667
"2439","11/5/2011",64,5,59,8.47457627118644
"2440","11/5/2012",72,0,72,0
"2441","11/5/2013",69,3,66,4.54545454545455
"2442","11/5/2014",75,4,71,5.63380281690141
"2443","11/5/2015",75,8,67,11.9402985074627
"2444","11/5/2016",58,2,56,3.57142857142857
"2445","11/5/2017",125,6,119,5.04201680672269
"2446","11/5/2018",75,2,73,2.73972602739726
"2447","11/5/2019",72,1,71,1.40845070422535
"2448","11/5/2020",67,6,61,9.83606557377049
"2449","11/6/1994",152,4,148,2.7027027027027
"2450","11/6/1995",75,0,75,0
"2451","11/6/1996",78,1,77,1.2987012987013
"2452","11/6/1997",65,0,65,0
"2453","11/6/1998",57,4,53,7.54716981132075
"2454","11/6/1999",67,6,61,9.83606557377049
"2455","11/6/2000",70,1,69,1.44927536231884
"2456","11/6/2001",74,2,72,2.77777777777778
"2457","11/6/2002",72,0,72,0
"2458","11/6/2003",70,2,68,2.94117647058824
"2459","11/6/2004",66,2,64,3.125
"2460","11/6/2005",122,3,119,2.52100840336134
"2461","11/6/2006",76,1,75,1.33333333333333
"2462","11/6/2007",72,0,72,0
"2463","11/6/2008",65,4,61,6.55737704918033
"2464","11/6/2009",59,3,56,5.35714285714286
"2465","11/6/2010",63,4,59,6.77966101694915
"2466","11/6/2011",121,6,115,5.21739130434783
"2467","11/6/2012",75,3,72,4.16666666666667
"2468","11/6/2013",73,1,72,1.38888888888889
"2469","11/6/2014",70,4,66,6.06060606060606
"2470","11/6/2015",58,3,55,5.45454545454545
"2471","11/6/2016",124,5,119,4.20168067226891
"2472","11/6/2017",72,1,71,1.40845070422535
"2473","11/6/2018",79,4,75,5.33333333333333
"2474","11/6/2019",71,2,69,2.89855072463768
"2475","11/6/2020",62,3,59,5.08474576271187
"2476","11/7/1994",72,1,71,1.40845070422535
"2477","11/7/1995",77,3,74,4.05405405405405
"2478","11/7/1996",68,2,66,3.03030303030303
"2479","11/7/1997",59,3,56,5.35714285714286
"2480","11/7/1998",62,0,62,0
"2481","11/7/1999",129,3,126,2.38095238095238
"2482","11/7/2000",72,3,69,4.34782608695652
"2483","11/7/2001",70,3,67,4.47761194029851
"2484","11/7/2002",67,2,65,3.07692307692308
"2485","11/7/2003",61,3,58,5.17241379310345
"2486","11/7/2004",127,1,126,0.793650793650794
"2487","11/7/2005",76,0,76,0
"2488","11/7/2006",74,2,72,2.77777777777778
"2489","11/7/2007",74,0,74,0
"2490","11/7/2008",60,2,58,3.44827586206897
"2491","11/7/2009",65,4,61,6.55737704918033
"2492","11/7/2010",125,8,117,6.83760683760684
"2493","11/7/2011",75,1,74,1.35135135135135
"2494","11/7/2012",72,2,70,2.85714285714286
"2495","11/7/2013",73,3,70,4.28571428571429
"2496","11/7/2014",56,3,53,5.66037735849057
"2497","11/7/2015",68,6,62,9.67741935483871
"2498","11/7/2016",68,0,68,0
"2499","11/7/2017",74,3,71,4.22535211267606
"2500","11/7/2018",75,2,73,2.73972602739726
"2501","11/7/2019",64,3,61,4.91803278688525
"2502","11/7/2020",60,3,57,5.26315789473684
"2503","11/8/1994",74,1,73,1.36986301369863
"2504","11/8/1995",66,0,66,0
"2505","11/8/1996",57,4,53,7.54716981132075
"2506","11/8/1997",60,0,60,0
"2507","11/8/1998",132,0,132,0
"2508","11/8/1999",69,1,68,1.47058823529412
"2509","11/8/2000",70,3,67,4.47761194029851
"2510","11/8/2001",65,1,64,1.5625
"2511","11/8/2002",58,3,55,5.45454545454545
"2512","11/8/2003",60,2,58,3.44827586206897
"2513","11/8/2004",71,0,71,0
"2514","11/8/2005",73,1,72,1.38888888888889
"2515","11/8/2006",71,6,65,9.23076923076923
"2516","11/8/2007",69,1,68,1.47058823529412
"2517","11/8/2008",48,2,46,4.34782608695652
"2518","11/8/2009",125,2,123,1.6260162601626
"2519","11/8/2010",74,2,72,2.77777777777778
"2520","11/8/2011",74,1,73,1.36986301369863
"2521","11/8/2012",67,4,63,6.34920634920635
"2522","11/8/2013",61,6,55,10.9090909090909
"2523","11/8/2014",65,5,60,8.33333333333333
"2524","11/8/2015",132,12,120,10
"2525","11/8/2016",72,3,69,4.34782608695652
"2526","11/8/2017",59,3,56,5.35714285714286
"2527","11/8/2018",66,3,63,4.76190476190476
"2528","11/8/2019",61,4,57,7.01754385964912
"2529","11/8/2020",129,10,119,8.40336134453782
"2530","11/9/1994",72,0,72,0
"2531","11/9/1995",65,0,65,0
"2532","11/9/1996",55,3,52,5.76923076923077
"2533","11/9/1997",126,2,124,1.61290322580645
"2534","11/9/1998",73,1,72,1.38888888888889
"2535","11/9/1999",75,1,74,1.35135135135135
"2536","11/9/2000",74,4,70,5.71428571428571
"2537","11/9/2001",64,5,59,8.47457627118644
"2538","11/9/2002",60,5,55,9.09090909090909
"2539","11/9/2003",120,6,114,5.26315789473684
"2540","11/9/2004",73,0,73,0
"2541","11/9/2005",75,0,75,0
"2542","11/9/2006",71,5,66,7.57575757575758
"2543","11/9/2007",53,5,48,10.4166666666667
"2544","11/9/2008",123,2,121,1.65289256198347
"2545","11/9/2009",77,1,76,1.31578947368421
"2546","11/9/2010",74,0,74,0
"2547","11/9/2011",65,1,64,1.5625
"2548","11/9/2012",67,3,64,4.6875
"2549","11/9/2013",59,4,55,7.27272727272727
"2550","11/9/2014",127,8,119,6.72268907563025
"2551","11/9/2015",72,0,72,0
"2552","11/9/2016",69,1,68,1.47058823529412
"2553","11/9/2017",64,1,63,1.58730158730159
"2554","11/9/2018",62,4,58,6.89655172413793
"2555","11/9/2019",61,2,59,3.38983050847458
"2556","11/9/2020",69,0,69,0
"2557","12/1/1993",70,1,69,1.44927536231884
"2558","12/1/1994",70,2,68,2.94117647058824
"2559","12/1/1995",60,3,57,5.26315789473684
"2560","12/1/1996",127,4,123,3.2520325203252
"2561","12/1/1997",68,2,66,3.03030303030303
"2562","12/1/1998",73,0,73,0
"2563","12/1/1999",73,0,73,0
"2564","12/1/2000",64,2,62,3.2258064516129
"2565","12/1/2001",69,4,65,6.15384615384615
"2566","12/1/2002",132,3,129,2.32558139534884
"2567","12/1/2003",78,0,78,0
"2568","12/1/2004",72,0,72,0
"2569","12/1/2005",65,7,58,12.0689655172414
"2570","12/1/2006",67,2,65,3.07692307692308
"2571","12/1/2007",47,0,47,0
"2572","12/1/2008",71,0,71,0
"2573","12/1/2009",72,0,72,0
"2574","12/1/2010",76,0,76,0
"2575","12/1/2011",71,2,69,2.89855072463768
"2576","12/1/2012",58,4,54,7.40740740740741
"2577","12/1/2013",124,4,120,3.33333333333333
"2578","12/1/2014",74,1,73,1.36986301369863
"2579","12/1/2015",71,1,70,1.42857142857143
"2580","12/1/2016",67,4,63,6.34920634920635
"2581","12/1/2017",62,1,61,1.63934426229508
"2582","12/1/2018",62,2,60,3.33333333333333
"2583","12/1/2019",136,8,128,6.25
"2584","12/1/2020",69,1,68,1.47058823529412
"2585","12/10/1993",71,2,69,2.89855072463768
"2586","12/10/1994",69,1,68,1.47058823529412
"2587","12/10/1995",114,4,110,3.63636363636364
"2588","12/10/1996",66,1,65,1.53846153846154
"2589","12/10/1997",75,1,74,1.35135135135135
"2590","12/10/1998",68,0,68,0
"2591","12/10/1999",65,7,58,12.0689655172414
"2592","12/10/2000",124,2,122,1.63934426229508
"2593","12/10/2001",77,0,77,0
"2594","12/10/2002",75,1,74,1.35135135135135
"2595","12/10/2003",67,4,63,6.34920634920635
"2596","12/10/2004",55,0,55,0
"2597","12/10/2005",64,1,63,1.58730158730159
"2598","12/10/2006",128,4,124,3.2258064516129
"2599","12/10/2007",76,1,75,1.33333333333333
"2600","12/10/2008",66,2,64,3.125
"2601","12/10/2009",75,5,70,7.14285714285714
"2602","12/10/2010",49,0,49,0
"2603","12/10/2011",61,5,56,8.92857142857143
"2604","12/10/2012",79,1,78,1.28205128205128
"2605","12/10/2013",71,3,68,4.41176470588235
"2606","12/10/2014",72,1,71,1.40845070422535
"2607","12/10/2015",71,6,65,9.23076923076923
"2608","12/10/2016",61,3,58,5.17241379310345
"2609","12/10/2017",118,3,115,2.60869565217391
"2610","12/10/2018",75,2,73,2.73972602739726
"2611","12/10/2019",70,0,70,0
"2612","12/10/2020",75,8,67,11.9402985074627
"2613","12/11/1993",72,1,71,1.40845070422535
"2614","12/11/1994",124,0,124,0
"2615","12/11/1995",72,0,72,0
"2616","12/11/1996",72,1,71,1.40845070422535
"2617","12/11/1997",64,3,61,4.91803278688525
"2618","12/11/1998",63,3,60,5
"2619","12/11/1999",57,2,55,3.63636363636364
"2620","12/11/2000",71,1,70,1.42857142857143
"2621","12/11/2001",74,2,72,2.77777777777778
"2622","12/11/2002",73,0,73,0
"2623","12/11/2003",64,0,64,0
"2624","12/11/2004",59,4,55,7.27272727272727
"2625","12/11/2005",132,3,129,2.32558139534884
"2626","12/11/2006",70,0,70,0
"2627","12/11/2007",75,3,72,4.16666666666667
"2628","12/11/2008",71,2,69,2.89855072463768
"2629","12/11/2009",60,3,57,5.26315789473684
"2630","12/11/2010",62,4,58,6.89655172413793
"2631","12/11/2011",121,2,119,1.68067226890756
"2632","12/11/2012",74,0,74,0
"2633","12/11/2013",71,2,69,2.89855072463768
"2634","12/11/2014",69,4,65,6.15384615384615
"2635","12/11/2015",64,2,62,3.2258064516129
"2636","12/11/2016",127,3,124,2.41935483870968
"2637","12/11/2017",73,0,73,0
"2638","12/11/2018",72,0,72,0
"2639","12/11/2019",69,1,68,1.47058823529412
"2640","12/11/2020",61,3,58,5.17241379310345
"2641","12/12/1993",128,7,121,5.78512396694215
"2642","12/12/1994",73,0,73,0
"2643","12/12/1995",74,0,74,0
"2644","12/12/1996",61,0,61,0
"2645","12/12/1997",59,1,58,1.72413793103448
"2646","12/12/1998",67,1,66,1.51515151515152
"2647","12/12/1999",127,6,121,4.95867768595041
"2648","12/12/2000",76,1,75,1.33333333333333
"2649","12/12/2001",70,3,67,4.47761194029851
"2650","12/12/2002",71,1,70,1.42857142857143
"2651","12/12/2003",63,2,61,3.27868852459016
"2652","12/12/2004",125,6,119,5.04201680672269
"2653","12/12/2005",75,0,75,0
"2654","12/12/2006",73,0,73,0
"2655","12/12/2007",75,2,73,2.73972602739726
"2656","12/12/2008",63,6,57,10.5263157894737
"2657","12/12/2009",58,2,56,3.57142857142857
"2658","12/12/2010",128,2,126,1.58730158730159
"2659","12/12/2011",72,1,71,1.40845070422535
"2660","12/12/2012",76,0,76,0
"2661","12/12/2013",71,5,66,7.57575757575758
"2662","12/12/2014",62,7,55,12.7272727272727
"2663","12/12/2015",52,6,46,13.0434782608696
"2664","12/12/2016",78,1,77,1.2987012987013
"2665","12/12/2017",72,4,68,5.88235294117647
"2666","12/12/2018",75,3,72,4.16666666666667
"2667","12/12/2019",58,2,56,3.57142857142857
"2668","12/12/2020",60,2,58,3.44827586206897
"2669","12/13/1993",69,1,68,1.47058823529412
"2670","12/13/1994",75,1,74,1.35135135135135
"2671","12/13/1995",73,1,72,1.38888888888889
"2672","12/13/1996",62,2,60,3.33333333333333
"2673","12/13/1997",65,4,61,6.55737704918033
"2674","12/13/1998",130,4,126,3.17460317460317
"2675","12/13/1999",75,0,75,0
"2676","12/13/2000",70,1,69,1.44927536231884
"2677","12/13/2001",60,3,57,5.26315789473684
"2678","12/13/2002",58,4,54,7.40740740740741
"2679","12/13/2003",58,0,58,0
"2680","12/13/2004",75,0,75,0
"2681","12/13/2005",73,2,71,2.8169014084507
"2682","12/13/2006",68,0,68,0
"2683","12/13/2007",71,5,66,7.57575757575758
"2684","12/13/2008",57,1,56,1.78571428571429
"2685","12/13/2009",123,4,119,3.36134453781513
"2686","12/13/2010",75,0,75,0
"2687","12/13/2011",76,1,75,1.33333333333333
"2688","12/13/2012",68,6,62,9.67741935483871
"2689","12/13/2013",65,6,59,10.1694915254237
"2690","12/13/2014",65,6,59,10.1694915254237
"2691","12/13/2015",128,3,125,2.4
"2692","12/13/2016",69,1,68,1.47058823529412
"2693","12/13/2017",62,1,61,1.63934426229508
"2694","12/13/2018",63,4,59,6.77966101694915
"2695","12/13/2019",65,2,63,3.17460317460317
"2696","12/13/2020",137,7,130,5.38461538461539
"2697","12/14/1993",71,0,71,0
"2698","12/14/1994",76,2,74,2.7027027027027
"2699","12/14/1995",67,1,66,1.51515151515152
"2700","12/14/1996",64,1,63,1.58730158730159
"2701","12/14/1997",126,3,123,2.4390243902439
"2702","12/14/1998",74,0,74,0
"2703","12/14/1999",73,0,73,0
"2704","12/14/2000",72,1,71,1.40845070422535
"2705","12/14/2001",65,2,63,3.17460317460317
"2706","12/14/2002",59,3,56,5.35714285714286
"2707","12/14/2003",128,6,122,4.91803278688525
"2708","12/14/2004",71,1,70,1.42857142857143
"2709","12/14/2005",66,0,66,0
"2710","12/14/2006",69,0,69,0
"2711","12/14/2007",64,1,63,1.58730158730159
"2712","12/14/2008",158,9,149,6.04026845637584
"2713","12/14/2009",68,2,66,3.03030303030303
"2714","12/14/2010",67,1,66,1.51515151515152
"2715","12/14/2011",69,0,69,0
"2716","12/14/2012",60,8,52,15.3846153846154
"2717","12/14/2013",62,5,57,8.7719298245614
"2718","12/14/2014",120,8,112,7.14285714285714
"2719","12/14/2015",66,1,65,1.53846153846154
"2720","12/14/2016",73,0,73,0
"2721","12/14/2017",69,3,66,4.54545454545455
"2722","12/14/2018",65,1,64,1.5625
"2723","12/14/2019",59,4,55,7.27272727272727
"2724","12/14/2020",67,1,66,1.51515151515152
"2725","12/15/1993",74,2,72,2.77777777777778
"2726","12/15/1994",65,0,65,0
"2727","12/15/1995",61,2,59,3.38983050847458
"2728","12/15/1996",122,2,120,1.66666666666667
"2729","12/15/1997",75,0,75,0
"2730","12/15/1998",74,1,73,1.36986301369863
"2731","12/15/1999",71,0,71,0
"2732","12/15/2000",61,5,56,8.92857142857143
"2733","12/15/2001",37,3,34,8.82352941176471
"2734","12/15/2002",132,2,130,1.53846153846154
"2735","12/15/2003",75,0,75,0
"2736","12/15/2004",72,1,71,1.40845070422535
"2737","12/15/2005",71,3,68,4.41176470588235
"2738","12/15/2006",56,1,55,1.81818181818182
"2739","12/15/2007",69,1,68,1.47058823529412
"2740","12/15/2008",75,1,74,1.35135135135135
"2741","12/15/2009",75,0,75,0
"2742","12/15/2010",74,1,73,1.36986301369863
"2743","12/15/2011",69,1,68,1.47058823529412
"2744","12/15/2012",63,4,59,6.77966101694915
"2745","12/15/2013",123,8,115,6.95652173913043
"2746","12/15/2014",72,2,70,2.85714285714286
"2747","12/15/2015",74,2,72,2.77777777777778
"2748","12/15/2016",73,2,71,2.8169014084507
"2749","12/15/2017",63,7,56,12.5
"2750","12/15/2018",56,6,50,12
"2751","12/15/2019",130,3,127,2.36220472440945
"2752","12/15/2020",73,5,68,7.35294117647059
"2753","12/16/1993",70,4,66,6.06060606060606
"2754","12/16/1994",70,1,69,1.44927536231884
"2755","12/16/1995",60,1,59,1.69491525423729
"2756","12/16/1996",76,0,76,0
"2757","12/16/1997",74,2,72,2.77777777777778
"2758","12/16/1998",72,4,68,5.88235294117647
"2759","12/16/1999",68,5,63,7.93650793650794
"2760","12/16/2000",59,4,55,7.27272727272727
"2761","12/16/2001",122,0,122,0
"2762","12/16/2002",69,0,69,0
"2763","12/16/2003",66,2,64,3.125
"2764","12/16/2004",67,1,66,1.51515151515152
"2765","12/16/2005",59,3,56,5.35714285714286
"2766","12/16/2006",67,2,65,3.07692307692308
"2767","12/16/2007",123,4,119,3.36134453781513
"2768","12/16/2008",75,0,75,0
"2769","12/16/2009",75,1,74,1.35135135135135
"2770","12/16/2010",63,4,59,6.77966101694915
"2771","12/16/2011",65,2,63,3.17460317460317
"2772","12/16/2012",108,8,100,8
"2773","12/16/2013",70,0,70,0
"2774","12/16/2014",70,0,70,0
"2775","12/16/2015",73,2,71,2.8169014084507
"2776","12/16/2016",61,4,57,7.01754385964912
"2777","12/16/2017",54,2,52,3.84615384615385
"2778","12/16/2018",120,6,114,5.26315789473684
"2779","12/16/2019",74,1,73,1.36986301369863
"2780","12/16/2020",68,1,67,1.49253731343284
"2781","12/17/1993",66,3,63,4.76190476190476
"2782","12/17/1994",51,1,50,2
"2783","12/17/1995",131,1,130,0.769230769230769
"2784","12/17/1996",77,0,77,0
"2785","12/17/1997",75,1,74,1.35135135135135
"2786","12/17/1998",65,2,63,3.17460317460317
"2787","12/17/1999",60,0,60,0
"2788","12/17/2000",132,7,125,5.6
"2789","12/17/2001",75,2,73,2.73972602739726
"2790","12/17/2002",77,6,71,8.45070422535211
"2791","12/17/2003",73,2,71,2.8169014084507
"2792","12/17/2004",63,3,60,5
"2793","12/17/2005",55,2,53,3.77358490566038
"2794","12/17/2006",114,7,107,6.54205607476635
"2795","12/17/2007",63,0,63,0
"2796","12/17/2008",73,1,72,1.38888888888889
"2797","12/17/2009",73,3,70,4.28571428571429
"2798","12/17/2010",54,4,50,8
"2799","12/17/2011",62,2,60,3.33333333333333
"2800","12/17/2012",77,0,77,0
"2801","12/17/2013",71,0,71,0
"2802","12/17/2014",68,1,67,1.49253731343284
"2803","12/17/2015",70,5,65,7.69230769230769
"2804","12/17/2016",59,2,57,3.50877192982456
"2805","12/17/2017",129,3,126,2.38095238095238
"2806","12/17/2018",75,1,74,1.35135135135135
"2807","12/17/2019",74,2,72,2.77777777777778
"2808","12/17/2020",73,5,68,7.35294117647059
"2809","12/18/1993",64,2,62,3.2258064516129
"2810","12/18/1994",150,6,144,4.16666666666667
"2811","12/18/1995",76,2,74,2.7027027027027
"2812","12/18/1996",74,2,72,2.77777777777778
"2813","12/18/1997",67,4,63,6.34920634920635
"2814","12/18/1998",68,4,64,6.25
"2815","12/18/1999",66,4,62,6.45161290322581
"2816","12/18/2000",75,0,75,0
"2817","12/18/2001",71,0,71,0
"2818","12/18/2002",69,0,69,0
"2819","12/18/2003",73,2,71,2.8169014084507
"2820","12/18/2004",60,2,58,3.44827586206897
"2821","12/18/2005",131,5,126,3.96825396825397
"2822","12/18/2006",73,0,73,0
"2823","12/18/2007",73,2,71,2.8169014084507
"2824","12/18/2008",70,5,65,7.69230769230769
"2825","12/18/2009",65,9,56,16.0714285714286
"2826","12/18/2010",58,1,57,1.75438596491228
"2827","12/18/2011",129,3,126,2.38095238095238
"2828","12/18/2012",79,3,76,3.94736842105263
"2829","12/18/2013",72,0,72,0
"2830","12/18/2014",70,4,66,6.06060606060606
"2831","12/18/2015",65,9,56,16.0714285714286
"2832","12/18/2016",130,1,129,0.775193798449612
"2833","12/18/2017",68,1,67,1.49253731343284
"2834","12/18/2018",72,4,68,5.88235294117647
"2835","12/18/2019",73,3,70,4.28571428571429
"2836","12/18/2020",69,4,65,6.15384615384615
"2837","12/19/1993",164,3,161,1.86335403726708
"2838","12/19/1994",76,0,76,0
"2839","12/19/1995",65,1,64,1.5625
"2840","12/19/1996",67,1,66,1.51515151515152
"2841","12/19/1997",69,2,67,2.98507462686567
"2842","12/19/1998",66,3,63,4.76190476190476
"2843","12/19/1999",129,1,128,0.78125
"2844","12/19/2000",72,1,71,1.40845070422535
"2845","12/19/2001",72,2,70,2.85714285714286
"2846","12/19/2002",65,2,63,3.17460317460317
"2847","12/19/2003",56,0,56,0
"2848","12/19/2004",131,4,127,3.1496062992126
"2849","12/19/2005",78,0,78,0
"2850","12/19/2006",72,0,72,0
"2851","12/19/2007",69,2,67,2.98507462686567
"2852","12/19/2008",61,5,56,8.92857142857143
"2853","12/19/2009",57,4,53,7.54716981132075
"2854","12/19/2010",153,5,148,3.37837837837838
"2855","12/19/2011",71,1,70,1.42857142857143
"2856","12/19/2012",71,2,69,2.89855072463768
"2857","12/19/2013",72,4,68,5.88235294117647
"2858","12/19/2014",61,5,56,8.92857142857143
"2859","12/19/2015",61,7,54,12.962962962963
"2860","12/19/2016",75,1,74,1.35135135135135
"2861","12/19/2017",75,5,70,7.14285714285714
"2862","12/19/2018",76,5,71,7.04225352112676
"2863","12/19/2019",64,3,61,4.91803278688525
"2864","12/19/2020",68,8,60,13.3333333333333
"2865","12/2/1993",71,2,69,2.89855072463768
"2866","12/2/1994",64,3,61,4.91803278688525
"2867","12/2/1995",64,0,64,0
"2868","12/2/1996",73,0,73,0
"2869","12/2/1997",74,1,73,1.36986301369863
"2870","12/2/1998",69,1,68,1.47058823529412
"2871","12/2/1999",71,2,69,2.89855072463768
"2872","12/2/2000",64,1,63,1.58730158730159
"2873","12/2/2001",125,0,125,0
"2874","12/2/2002",76,0,76,0
"2875","12/2/2003",72,0,72,0
"2876","12/2/2004",66,1,65,1.53846153846154
"2877","12/2/2005",70,2,68,2.94117647058824
"2878","12/2/2006",59,7,52,13.4615384615385
"2879","12/2/2007",131,8,123,6.50406504065041
"2880","12/2/2008",75,2,73,2.73972602739726
"2881","12/2/2009",73,1,72,1.38888888888889
"2882","12/2/2010",78,6,72,8.33333333333333
"2883","12/2/2011",64,6,58,10.3448275862069
"2884","12/2/2012",123,3,120,2.5
"2885","12/2/2013",75,1,74,1.35135135135135
"2886","12/2/2014",75,0,75,0
"2887","12/2/2015",71,8,63,12.6984126984127
"2888","12/2/2016",65,5,60,8.33333333333333
"2889","12/2/2017",53,4,49,8.16326530612245
"2890","12/2/2018",131,7,124,5.64516129032258
"2891","12/2/2019",74,0,74,0
"2892","12/2/2020",67,1,66,1.51515151515152
"2893","12/20/1993",74,2,72,2.77777777777778
"2894","12/20/1994",76,0,76,0
"2895","12/20/1995",71,0,71,0
"2896","12/20/1996",56,6,50,12
"2897","12/20/1997",66,2,64,3.125
"2898","12/20/1998",126,2,124,1.61290322580645
"2899","12/20/1999",74,1,73,1.36986301369863
"2900","12/20/2000",73,2,71,2.8169014084507
"2901","12/20/2001",72,2,70,2.85714285714286
"2902","12/20/2002",54,1,53,1.88679245283019
"2903","12/20/2003",64,2,62,3.2258064516129
"2904","12/20/2004",75,0,75,0
"2905","12/20/2005",71,2,69,2.89855072463768
"2906","12/20/2006",69,2,67,2.98507462686567
"2907","12/20/2007",70,0,70,0
"2908","12/20/2008",66,6,60,10
"2909","12/20/2009",131,7,124,5.64516129032258
"2910","12/20/2010",73,0,73,0
"2911","12/20/2011",69,1,68,1.47058823529412
"2912","12/20/2012",69,3,66,4.54545454545455
"2913","12/20/2013",66,7,59,11.864406779661
"2914","12/20/2014",59,9,50,18
"2915","12/20/2015",129,5,124,4.03225806451613
"2916","12/20/2016",65,3,62,4.83870967741935
"2917","12/20/2017",68,1,67,1.49253731343284
"2918","12/20/2018",67,6,61,9.83606557377049
"2919","12/20/2019",66,2,64,3.125
"2920","12/20/2020",135,4,131,3.05343511450382
"2921","12/21/1993",75,3,72,4.16666666666667
"2922","12/21/1994",70,1,69,1.44927536231884
"2923","12/21/1995",67,1,66,1.51515151515152
"2924","12/21/1996",59,3,56,5.35714285714286
"2925","12/21/1997",131,3,128,2.34375
"2926","12/21/1998",77,0,77,0
"2927","12/21/1999",72,1,71,1.40845070422535
"2928","12/21/2000",67,3,64,4.6875
"2929","12/21/2001",66,4,62,6.45161290322581
"2930","12/21/2002",63,4,59,6.77966101694915
"2931","12/21/2003",129,0,129,0
"2932","12/21/2004",74,1,73,1.36986301369863
"2933","12/21/2005",75,2,73,2.73972602739726
"2934","12/21/2006",68,3,65,4.61538461538462
"2935","12/21/2007",52,5,47,10.6382978723404
"2936","12/21/2008",131,8,123,6.50406504065041
"2937","12/21/2009",71,1,70,1.42857142857143
"2938","12/21/2010",68,0,68,0
"2939","12/21/2011",73,2,71,2.8169014084507
"2940","12/21/2012",69,3,66,4.54545454545455
"2941","12/21/2013",61,3,58,5.17241379310345
"2942","12/21/2014",120,6,114,5.26315789473684
"2943","12/21/2015",74,0,74,0
"2944","12/21/2016",67,3,64,4.6875
"2945","12/21/2017",69,6,63,9.52380952380952
"2946","12/21/2018",61,2,59,3.38983050847458
"2947","12/21/2019",63,2,61,3.27868852459016
"2948","12/21/2020",73,1,72,1.38888888888889
"2949","12/22/1993",68,3,65,4.61538461538462
"2950","12/22/1994",68,0,68,0
"2951","12/22/1995",57,1,56,1.78571428571429
"2952","12/22/1996",129,4,125,3.2
"2953","12/22/1997",75,0,75,0
"2954","12/22/1998",70,2,68,2.94117647058824
"2955","12/22/1999",73,0,73,0
"2956","12/22/2000",69,3,66,4.54545454545455
"2957","12/22/2001",48,1,47,2.12765957446809
"2958","12/22/2002",131,3,128,2.34375
"2959","12/22/2003",74,1,73,1.36986301369863
"2960","12/22/2004",71,1,70,1.42857142857143
"2961","12/22/2005",62,0,62,0
"2962","12/22/2006",67,3,64,4.6875
"2963","12/22/2007",48,4,44,9.09090909090909
"2964","12/22/2008",74,1,73,1.36986301369863
"2965","12/22/2009",72,0,72,0
"2966","12/22/2010",74,1,73,1.36986301369863
"2967","12/22/2011",69,1,68,1.47058823529412
"2968","12/22/2012",61,4,57,7.01754385964912
"2969","12/22/2013",126,1,125,0.8
"2970","12/22/2014",75,1,74,1.35135135135135
"2971","12/22/2015",74,1,73,1.36986301369863
"2972","12/22/2016",73,2,71,2.8169014084507
"2973","12/22/2017",52,5,47,10.6382978723404
"2974","12/22/2018",59,6,53,11.3207547169811
"2975","12/22/2019",121,4,117,3.41880341880342
"2976","12/22/2020",71,1,70,1.42857142857143
"2977","12/23/1993",65,2,63,3.17460317460317
"2978","12/23/1994",50,0,50,0
"2979","12/23/1995",53,0,53,0
"2980","12/23/1996",70,0,70,0
"2981","12/23/1997",74,3,71,4.22535211267606
"2982","12/23/1998",73,1,72,1.38888888888889
"2983","12/23/1999",70,3,67,4.47761194029851
"2984","12/23/2000",57,3,54,5.55555555555556
"2985","12/23/2001",129,1,128,0.78125
"2986","12/23/2002",75,0,75,0
"2987","12/23/2003",77,0,77,0
"2988","12/23/2004",72,1,71,1.40845070422535
"2989","12/23/2005",61,1,60,1.66666666666667
"2990","12/23/2006",56,7,49,14.2857142857143
"2991","12/23/2007",133,8,125,6.4
"2992","12/23/2008",82,2,80,2.5
"2993","12/23/2009",72,3,69,4.34782608695652
"2994","12/23/2010",70,3,67,4.47761194029851
"2995","12/23/2011",55,3,52,5.76923076923077
"2996","12/23/2012",130,5,125,4
"2997","12/23/2013",74,1,73,1.36986301369863
"2998","12/23/2014",74,0,74,0
"2999","12/23/2015",71,2,69,2.89855072463768
"3000","12/23/2016",65,8,57,14.0350877192982
"3001","12/23/2017",57,3,54,5.55555555555556
"3002","12/23/2018",129,5,124,4.03225806451613
"3003","12/23/2019",67,2,65,3.07692307692308
"3004","12/23/2020",72,4,68,5.88235294117647
"3005","12/24/1993",65,0,65,0
"3006","12/24/1994",60,0,60,0
"3007","12/24/1995",127,1,126,0.793650793650794
"3008","12/24/1996",71,0,71,0
"3009","12/24/1997",68,0,68,0
"3010","12/24/1998",69,1,68,1.47058823529412
"3011","12/24/1999",67,2,65,3.07692307692308
"3012","12/24/2000",135,4,131,3.05343511450382
"3013","12/24/2001",75,0,75,0
"3014","12/24/2002",68,1,67,1.49253731343284
"3015","12/24/2003",70,0,70,0
"3016","12/24/2004",63,4,59,6.77966101694915
"3017","12/24/2005",51,3,48,6.25
"3018","12/24/2006",124,3,121,2.47933884297521
"3019","12/24/2007",73,0,73,0
"3020","12/24/2008",72,1,71,1.40845070422535
"3021","12/24/2009",72,0,72,0
"3022","12/24/2010",72,5,67,7.46268656716418
"3023","12/24/2011",59,6,53,11.3207547169811
"3024","12/24/2012",70,1,69,1.44927536231884
"3025","12/24/2013",71,0,71,0
"3026","12/24/2014",73,4,69,5.79710144927536
"3027","12/24/2015",64,5,59,8.47457627118644
"3028","12/24/2016",65,4,61,6.55737704918033
"3029","12/24/2017",125,9,116,7.75862068965517
"3030","12/24/2018",66,0,66,0
"3031","12/24/2019",69,1,68,1.47058823529412
"3032","12/24/2020",68,0,68,0
"3033","12/25/1993",59,5,54,9.25925925925926
"3034","12/25/1994",127,3,124,2.41935483870968
"3035","12/25/1995",75,0,75,0
"3036","12/25/1996",69,2,67,2.98507462686567
"3037","12/25/1997",68,0,68,0
"3038","12/25/1998",62,1,61,1.63934426229508
"3039","12/25/1999",72,2,70,2.85714285714286
"3040","12/25/2000",75,1,74,1.35135135135135
"3041","12/25/2001",72,1,71,1.40845070422535
"3042","12/25/2002",75,0,75,0
"3043","12/25/2003",77,2,75,2.66666666666667
"3044","12/25/2004",67,4,63,6.34920634920635
"3045","12/25/2005",127,2,125,1.6
"3046","12/25/2006",74,1,73,1.36986301369863
"3047","12/25/2007",72,2,70,2.85714285714286
"3048","12/25/2008",70,2,68,2.94117647058824
"3049","12/25/2009",66,3,63,4.76190476190476
"3050","12/25/2010",69,2,67,2.98507462686567
"3051","12/25/2011",166,10,156,6.41025641025641
"3052","12/25/2012",70,2,68,2.94117647058824
"3053","12/25/2013",75,2,73,2.73972602739726
"3054","12/25/2014",74,4,70,5.71428571428571
"3055","12/25/2015",58,4,54,7.40740740740741
"3056","12/25/2016",129,6,123,4.8780487804878
"3057","12/25/2017",78,1,77,1.2987012987013
"3058","12/25/2018",72,2,70,2.85714285714286
"3059","12/25/2019",67,1,66,1.51515151515152
"3060","12/25/2020",67,2,65,3.07692307692308
"3061","12/26/1993",123,5,118,4.23728813559322
"3062","12/26/1994",73,0,73,0
"3063","12/26/1995",72,1,71,1.40845070422535
"3064","12/26/1996",69,0,69,0
"3065","12/26/1997",63,3,60,5
"3066","12/26/1998",67,2,65,3.07692307692308
"3067","12/26/1999",134,3,131,2.29007633587786
"3068","12/26/2000",73,3,70,4.28571428571429
"3069","12/26/2001",69,3,66,4.54545454545455
"3070","12/26/2002",67,1,66,1.51515151515152
"3071","12/26/2003",68,0,68,0
"3072","12/26/2004",127,3,124,2.41935483870968
"3073","12/26/2005",76,0,76,0
"3074","12/26/2006",72,1,71,1.40845070422535
"3075","12/26/2007",73,1,72,1.38888888888889
"3076","12/26/2008",66,3,63,4.76190476190476
"3077","12/26/2009",64,2,62,3.2258064516129
"3078","12/26/2010",123,1,122,0.819672131147541
"3079","12/26/2011",68,1,67,1.49253731343284
"3080","12/26/2012",73,0,73,0
"3081","12/26/2013",68,6,62,9.67741935483871
"3082","12/26/2014",61,7,54,12.962962962963
"3083","12/26/2015",61,4,57,7.01754385964912
"3084","12/26/2016",74,0,74,0
"3085","12/26/2017",70,0,70,0
"3086","12/26/2018",76,10,66,15.1515151515152
"3087","12/26/2019",74,2,72,2.77777777777778
"3088","12/26/2020",62,5,57,8.7719298245614
"3089","12/27/1993",69,4,65,6.15384615384615
"3090","12/27/1994",63,1,62,1.61290322580645
"3091","12/27/1995",72,1,71,1.40845070422535
"3092","12/27/1996",56,2,54,3.7037037037037
"3093","12/27/1997",61,5,56,8.92857142857143
"3094","12/27/1998",124,3,121,2.47933884297521
"3095","12/27/1999",77,1,76,1.31578947368421
"3096","12/27/2000",74,7,67,10.4477611940298
"3097","12/27/2001",65,9,56,16.0714285714286
"3098","12/27/2002",62,3,59,5.08474576271187
"3099","12/27/2003",59,0,59,0
"3100","12/27/2004",74,1,73,1.36986301369863
"3101","12/27/2005",73,1,72,1.38888888888889
"3102","12/27/2006",72,2,70,2.85714285714286
"3103","12/27/2007",67,0,67,0
"3104","12/27/2008",61,7,54,12.962962962963
"3105","12/27/2009",125,6,119,5.04201680672269
"3106","12/27/2010",74,0,74,0
"3107","12/27/2011",73,0,73,0
"3108","12/27/2012",67,1,66,1.51515151515152
"3109","12/27/2013",63,3,60,5
"3110","12/27/2014",54,3,51,5.88235294117647
"3111","12/27/2015",127,2,125,1.6
"3112","12/27/2016",75,4,71,5.63380281690141
"3113","12/27/2017",78,3,75,4
"3114","12/27/2018",63,4,59,6.77966101694915
"3115","12/27/2019",58,3,55,5.45454545454545
"3116","12/27/2020",130,6,124,4.83870967741935
"3117","12/28/1993",69,0,69,0
"3118","12/28/1994",60,0,60,0
"3119","12/28/1995",71,2,69,2.89855072463768
"3120","12/28/1996",62,0,62,0
"3121","12/28/1997",142,0,142,0
"3122","12/28/1998",76,1,75,1.33333333333333
"3123","12/28/1999",75,1,74,1.35135135135135
"3124","12/28/2000",65,4,61,6.55737704918033
"3125","12/28/2001",58,2,56,3.57142857142857
"3126","12/28/2002",67,3,64,4.6875
"3127","12/28/2003",134,7,127,5.51181102362205
"3128","12/28/2004",71,1,70,1.42857142857143
"3129","12/28/2005",70,1,69,1.44927536231884
"3130","12/28/2006",67,0,67,0
"3131","12/28/2007",61,1,60,1.66666666666667
"3132","12/28/2008",127,4,123,3.2520325203252
"3133","12/28/2009",78,0,78,0
"3134","12/28/2010",74,0,74,0
"3135","12/28/2011",72,3,69,4.34782608695652
"3136","12/28/2012",70,5,65,7.69230769230769
"3137","12/28/2013",70,6,64,9.375
"3138","12/28/2014",129,4,125,3.2
"3139","12/28/2015",73,0,73,0
"3140","12/28/2016",71,2,69,2.89855072463768
"3141","12/28/2017",70,2,68,2.94117647058824
"3142","12/28/2018",60,2,58,3.44827586206897
"3143","12/28/2019",66,6,60,10
"3144","12/28/2020",77,1,76,1.31578947368421
"3145","12/29/1993",65,5,60,8.33333333333333
"3146","12/29/1994",71,1,70,1.42857142857143
"3147","12/29/1995",64,1,63,1.58730158730159
"3148","12/29/1996",113,2,111,1.8018018018018
"3149","12/29/1997",74,1,73,1.36986301369863
"3150","12/29/1998",68,1,67,1.49253731343284
"3151","12/29/1999",72,2,70,2.85714285714286
"3152","12/29/2000",69,3,66,4.54545454545455
"3153","12/29/2001",60,1,59,1.69491525423729
"3154","12/29/2002",129,0,129,0
"3155","12/29/2003",75,0,75,0
"3156","12/29/2004",74,1,73,1.36986301369863
"3157","12/29/2005",66,3,63,4.76190476190476
"3158","12/29/2006",66,4,62,6.45161290322581
"3159","12/29/2007",58,4,54,7.40740740740741
"3160","12/29/2008",70,1,69,1.44927536231884
"3161","12/29/2009",73,0,73,0
"3162","12/29/2010",72,1,71,1.40845070422535
"3163","12/29/2011",69,3,66,4.54545454545455
"3164","12/29/2012",49,0,49,0
"3165","12/29/2013",129,8,121,6.61157024793388
"3166","12/29/2014",72,1,71,1.40845070422535
"3167","12/29/2015",73,5,68,7.35294117647059
"3168","12/29/2016",69,0,69,0
"3169","12/29/2017",64,3,61,4.91803278688525
"3170","12/29/2018",65,3,62,4.83870967741935
"3171","12/29/2019",126,6,120,5
"3172","12/29/2020",72,0,72,0
"3173","12/3/1993",72,4,68,5.88235294117647
"3174","12/3/1994",71,1,70,1.42857142857143
"3175","12/3/1995",104,3,101,2.97029702970297
"3176","12/3/1996",76,0,76,0
"3177","12/3/1997",64,1,63,1.58730158730159
"3178","12/3/1998",71,4,67,5.97014925373134
"3179","12/3/1999",63,5,58,8.62068965517241
"3180","12/3/2000",123,3,120,2.5
"3181","12/3/2001",75,1,74,1.35135135135135
"3182","12/3/2002",74,2,72,2.77777777777778
"3183","12/3/2003",70,1,69,1.44927536231884
"3184","12/3/2004",70,8,62,12.9032258064516
"3185","12/3/2005",62,3,59,5.08474576271187
"3186","12/3/2006",124,5,119,4.20168067226891
"3187","12/3/2007",69,0,69,0
"3188","12/3/2008",72,1,71,1.40845070422535
"3189","12/3/2009",67,3,64,4.6875
"3190","12/3/2010",67,11,56,19.6428571428571
"3191","12/3/2011",66,3,63,4.76190476190476
"3192","12/3/2012",76,0,76,0
"3193","12/3/2013",73,1,72,1.38888888888889
"3194","12/3/2014",75,9,66,13.6363636363636
"3195","12/3/2015",75,4,71,5.63380281690141
"3196","12/3/2016",52,2,50,4
"3197","12/3/2017",137,6,131,4.58015267175572
"3198","12/3/2018",76,0,76,0
"3199","12/3/2019",71,1,70,1.42857142857143
"3200","12/3/2020",70,2,68,2.94117647058824
"3201","12/30/1993",64,2,62,3.2258064516129
"3202","12/30/1994",68,0,68,0
"3203","12/30/1995",64,2,62,3.2258064516129
"3204","12/30/1996",77,0,77,0
"3205","12/30/1997",69,1,68,1.47058823529412
"3206","12/30/1998",73,2,71,2.8169014084507
"3207","12/30/1999",68,1,67,1.49253731343284
"3208","12/30/2000",66,2,64,3.125
"3209","12/30/2001",119,7,112,6.25
"3210","12/30/2002",70,1,69,1.44927536231884
"3211","12/30/2003",74,0,74,0
"3212","12/30/2004",75,1,74,1.35135135135135
"3213","12/30/2005",66,7,59,11.864406779661
"3214","12/30/2006",66,3,63,4.76190476190476
"3215","12/30/2007",144,9,135,6.66666666666667
"3216","12/30/2008",68,0,68,0
"3217","12/30/2009",70,1,69,1.44927536231884
"3218","12/30/2010",61,2,59,3.38983050847458
"3219","12/30/2011",59,5,54,9.25925925925926
"3220","12/30/2012",126,4,122,3.27868852459016
"3221","12/30/2013",68,1,67,1.49253731343284
"3222","12/30/2014",72,1,71,1.40845070422535
"3223","12/30/2015",69,3,66,4.54545454545455
"3224","12/30/2016",62,4,58,6.89655172413793
"3225","12/30/2017",67,4,63,6.34920634920635
"3226","12/30/2018",129,5,124,4.03225806451613
"3227","12/30/2019",76,0,76,0
"3228","12/30/2020",71,3,68,4.41176470588235
"3229","12/31/1993",67,1,66,1.51515151515152
"3230","12/31/1994",65,2,63,3.17460317460317
"3231","12/31/1995",142,7,135,5.18518518518519
"3232","12/31/1996",74,0,74,0
"3233","12/31/1997",68,1,67,1.49253731343284
"3234","12/31/1998",70,3,67,4.47761194029851
"3235","12/31/1999",74,1,73,1.36986301369863
"3236","12/31/2000",115,5,110,4.54545454545455
"3237","12/31/2001",75,2,73,2.73972602739726
"3238","12/31/2002",72,3,69,4.34782608695652
"3239","12/31/2003",74,2,72,2.77777777777778
"3240","12/31/2004",69,1,68,1.47058823529412
"3241","12/31/2005",59,1,58,1.72413793103448
"3242","12/31/2006",145,2,143,1.3986013986014
"3243","12/31/2007",75,0,75,0
"3244","12/31/2008",73,3,70,4.28571428571429
"3245","12/31/2009",70,5,65,7.69230769230769
"3246","12/31/2010",66,7,59,11.864406779661
"3247","12/31/2011",62,5,57,8.7719298245614
"3248","12/31/2012",73,0,73,0
"3249","12/31/2013",74,2,72,2.77777777777778
"3250","12/31/2014",69,2,67,2.98507462686567
"3251","12/31/2015",70,9,61,14.7540983606557
"3252","12/31/2016",57,5,52,9.61538461538462
"3253","12/31/2017",124,6,118,5.08474576271187
"3254","12/31/2018",70,2,68,2.94117647058824
"3255","12/31/2019",69,2,67,2.98507462686567
"3256","12/31/2020",66,3,63,4.76190476190476
"3257","12/4/1993",70,4,66,6.06060606060606
"3258","12/4/1994",121,3,118,2.54237288135593
"3259","12/4/1995",76,0,76,0
"3260","12/4/1996",77,1,76,1.31578947368421
"3261","12/4/1997",67,2,65,3.07692307692308
"3262","12/4/1998",67,4,63,6.34920634920635
"3263","12/4/1999",65,1,64,1.5625
"3264","12/4/2000",78,1,77,1.2987012987013
"3265","12/4/2001",66,5,61,8.19672131147541
"3266","12/4/2002",72,3,69,4.34782608695652
"3267","12/4/2003",66,2,64,3.125
"3268","12/4/2004",70,2,68,2.94117647058824
"3269","12/4/2005",156,2,154,1.2987012987013
"3270","12/4/2006",73,0,73,0
"3271","12/4/2007",73,0,73,0
"3272","12/4/2008",64,1,63,1.58730158730159
"3273","12/4/2009",63,4,59,6.77966101694915
"3274","12/4/2010",67,5,62,8.06451612903226
"3275","12/4/2011",126,7,119,5.88235294117647
"3276","12/4/2012",66,1,65,1.53846153846154
"3277","12/4/2013",70,0,70,0
"3278","12/4/2014",78,6,72,8.33333333333333
"3279","12/4/2015",60,7,53,13.2075471698113
"3280","12/4/2016",121,2,119,1.68067226890756
"3281","12/4/2017",74,3,71,4.22535211267606
"3282","12/4/2018",70,3,67,4.47761194029851
"3283","12/4/2019",72,1,71,1.40845070422535
"3284","12/4/2020",62,6,56,10.7142857142857
"3285","12/5/1993",130,6,124,4.83870967741935
"3286","12/5/1994",75,0,75,0
"3287","12/5/1995",75,1,74,1.35135135135135
"3288","12/5/1996",70,0,70,0
"3289","12/5/1997",62,5,57,8.7719298245614
"3290","12/5/1998",67,3,64,4.6875
"3291","12/5/1999",157,15,142,10.5633802816901
"3292","12/5/2000",71,1,70,1.42857142857143
"3293","12/5/2001",75,2,73,2.73972602739726
"3294","12/5/2002",63,1,62,1.61290322580645
"3295","12/5/2003",65,3,62,4.83870967741935
"3296","12/5/2004",132,3,129,2.32558139534884
"3297","12/5/2005",70,0,70,0
"3298","12/5/2006",71,0,71,0
"3299","12/5/2007",75,0,75,0
"3300","12/5/2008",68,6,62,9.67741935483871
"3301","12/5/2009",63,4,59,6.77966101694915
"3302","12/5/2010",139,5,134,3.73134328358209
"3303","12/5/2011",74,1,73,1.36986301369863
"3304","12/5/2012",74,2,72,2.77777777777778
"3305","12/5/2013",73,6,67,8.95522388059701
"3306","12/5/2014",63,6,57,10.5263157894737
"3307","12/5/2015",69,6,63,9.52380952380952
"3308","12/5/2016",72,0,72,0
"3309","12/5/2017",69,3,66,4.54545454545455
"3310","12/5/2018",70,2,68,2.94117647058824
"3311","12/5/2019",74,2,72,2.77777777777778
"3312","12/5/2020",60,2,58,3.44827586206897
"3313","12/6/1993",77,3,74,4.05405405405405
"3314","12/6/1994",70,0,70,0
"3315","12/6/1995",75,1,74,1.35135135135135
"3316","12/6/1996",63,1,62,1.61290322580645
"3317","12/6/1997",58,0,58,0
"3318","12/6/1998",129,2,127,1.5748031496063
"3319","12/6/1999",76,0,76,0
"3320","12/6/2000",70,1,69,1.44927536231884
"3321","12/6/2001",68,2,66,3.03030303030303
"3322","12/6/2002",69,2,67,2.98507462686567
"3323","12/6/2003",62,1,61,1.63934426229508
"3324","12/6/2004",77,0,77,0
"3325","12/6/2005",69,0,69,0
"3326","12/6/2006",70,1,69,1.44927536231884
"3327","12/6/2007",72,0,72,0
"3328","12/6/2008",77,6,71,8.45070422535211
"3329","12/6/2009",117,6,111,5.40540540540541
"3330","12/6/2010",71,0,71,0
"3331","12/6/2011",78,9,69,13.0434782608696
"3332","12/6/2012",75,2,73,2.73972602739726
"3333","12/6/2013",68,5,63,7.93650793650794
"3334","12/6/2014",64,8,56,14.2857142857143
"3335","12/6/2015",123,6,117,5.12820512820513
"3336","12/6/2016",76,3,73,4.10958904109589
"3337","12/6/2017",78,1,77,1.2987012987013
"3338","12/6/2018",79,0,79,0
"3339","12/6/2019",62,6,56,10.7142857142857
"3340","12/6/2020",127,5,122,4.0983606557377
"3341","12/7/1993",64,0,64,0
"3342","12/7/1994",67,0,67,0
"3343","12/7/1995",69,1,68,1.47058823529412
"3344","12/7/1996",66,0,66,0
"3345","12/7/1997",119,1,118,0.847457627118644
"3346","12/7/1998",76,1,75,1.33333333333333
"3347","12/7/1999",70,2,68,2.94117647058824
"3348","12/7/2000",67,0,67,0
"3349","12/7/2001",62,7,55,12.7272727272727
"3350","12/7/2002",60,1,59,1.69491525423729
"3351","12/7/2003",129,4,125,3.2
"3352","12/7/2004",75,0,75,0
"3353","12/7/2005",64,1,63,1.58730158730159
"3354","12/7/2006",65,4,61,6.55737704918033
"3355","12/7/2007",58,2,56,3.57142857142857
"3356","12/7/2008",114,3,111,2.7027027027027
"3357","12/7/2009",72,1,71,1.40845070422535
"3358","12/7/2010",73,2,71,2.8169014084507
"3359","12/7/2011",70,0,70,0
"3360","12/7/2012",55,2,53,3.77358490566038
"3361","12/7/2013",67,8,59,13.5593220338983
"3362","12/7/2014",128,3,125,2.4
"3363","12/7/2015",72,0,72,0
"3364","12/7/2016",70,1,69,1.44927536231884
"3365","12/7/2017",71,2,69,2.89855072463768
"3366","12/7/2018",57,4,53,7.54716981132075
"3367","12/7/2019",57,8,49,16.3265306122449
"3368","12/7/2020",73,2,71,2.8169014084507
"3369","12/8/1993",74,2,72,2.77777777777778
"3370","12/8/1994",68,1,67,1.49253731343284
"3371","12/8/1995",67,0,67,0
"3372","12/8/1996",127,3,124,2.41935483870968
"3373","12/8/1997",78,0,78,0
"3374","12/8/1998",66,1,65,1.53846153846154
"3375","12/8/1999",72,2,70,2.85714285714286
"3376","12/8/2000",60,4,56,7.14285714285714
"3377","12/8/2001",64,2,62,3.2258064516129
"3378","12/8/2002",148,5,143,3.4965034965035
"3379","12/8/2003",75,0,75,0
"3380","12/8/2004",71,1,70,1.42857142857143
"3381","12/8/2005",72,1,71,1.40845070422535
"3382","12/8/2006",64,2,62,3.2258064516129
"3383","12/8/2007",59,7,52,13.4615384615385
"3384","12/8/2008",74,2,72,2.77777777777778
"3385","12/8/2009",79,1,78,1.28205128205128
"3386","12/8/2010",73,1,72,1.38888888888889
"3387","12/8/2011",65,5,60,8.33333333333333
"3388","12/8/2012",70,8,62,12.9032258064516
"3389","12/8/2013",134,15,119,12.6050420168067
"3390","12/8/2014",75,0,75,0
"3391","12/8/2015",75,1,74,1.35135135135135
"3392","12/8/2016",73,8,65,12.3076923076923
"3393","12/8/2017",60,3,57,5.26315789473684
"3394","12/8/2018",60,7,53,13.2075471698113
"3395","12/8/2019",131,6,125,4.8
"3396","12/8/2020",77,1,76,1.31578947368421
"3397","12/9/1993",76,2,74,2.7027027027027
"3398","12/9/1994",56,1,55,1.81818181818182
"3399","12/9/1995",63,1,62,1.61290322580645
"3400","12/9/1996",74,1,73,1.36986301369863
"3401","12/9/1997",70,1,69,1.44927536231884
"3402","12/9/1998",73,1,72,1.38888888888889
"3403","12/9/1999",66,0,66,0
"3404","12/9/2000",54,2,52,3.84615384615385
"3405","12/9/2001",117,1,116,0.862068965517241
"3406","12/9/2002",72,0,72,0
"3407","12/9/2003",71,2,69,2.89855072463768
"3408","12/9/2004",66,1,65,1.53846153846154
"3409","12/9/2005",60,3,57,5.26315789473684
"3410","12/9/2006",48,1,47,2.12765957446809
"3411","12/9/2007",128,9,119,7.56302521008403
"3412","12/9/2008",74,1,73,1.36986301369863
"3413","12/9/2009",71,1,70,1.42857142857143
"3414","12/9/2010",73,4,69,5.79710144927536
"3415","12/9/2011",63,4,59,6.77966101694915
"3416","12/9/2012",123,8,115,6.95652173913043
"3417","12/9/2013",76,2,74,2.7027027027027
"3418","12/9/2014",71,4,67,5.97014925373134
"3419","12/9/2015",73,0,73,0
"3420","12/9/2016",57,4,53,7.54716981132075
"3421","12/9/2017",56,5,51,9.80392156862745
"3422","12/9/2018",125,4,121,3.30578512396694
"3423","12/9/2019",73,0,73,0
"3424","12/9/2020",65,3,62,4.83870967741935
"3425","2/1/1994",77,2,75,2.66666666666667
"3426","2/1/1995",74,0,74,0
"3427","2/1/1996",68,1,67,1.49253731343284
"3428","2/1/1997",63,2,61,3.27868852459016
"3429","2/1/1998",121,3,118,2.54237288135593
"3430","2/1/1999",75,0,75,0
"3431","2/1/2000",74,1,73,1.36986301369863
"3432","2/1/2001",69,2,67,2.98507462686567
"3433","2/1/2002",65,2,63,3.17460317460317
"3434","2/1/2003",65,0,65,0
"3435","2/1/2004",151,4,147,2.72108843537415
"3436","2/1/2005",73,0,73,0
"3437","2/1/2006",70,2,68,2.94117647058824
"3438","2/1/2007",74,1,73,1.36986301369863
"3439","2/1/2008",63,4,59,6.77966101694915
"3440","2/1/2009",159,10,149,6.71140939597315
"3441","2/1/2010",72,0,72,0
"3442","2/1/2011",75,0,75,0
"3443","2/1/2012",72,0,72,0
"3444","2/1/2013",60,5,55,9.09090909090909
"3445","2/1/2014",61,3,58,5.17241379310345
"3446","2/1/2015",129,10,119,8.40336134453782
"3447","2/1/2016",71,0,71,0
"3448","2/1/2017",67,2,65,3.07692307692308
"3449","2/1/2018",73,9,64,14.0625
"3450","2/1/2019",71,4,67,5.97014925373134
"3451","2/1/2020",54,6,48,12.5
"3452","2/1/2021",70,0,70,0
"3453","2/10/1994",69,5,64,7.8125
"3454","2/10/1995",66,3,63,4.76190476190476
"3455","2/10/1996",54,0,54,0
"3456","2/10/1997",75,0,75,0
"3457","2/10/1998",71,0,71,0
"3458","2/10/1999",72,1,71,1.40845070422535
"3459","2/10/2000",70,1,69,1.44927536231884
"3460","2/10/2001",62,2,60,3.33333333333333
"3461","2/10/2002",127,10,117,8.54700854700855
"3462","2/10/2003",76,0,76,0
"3463","2/10/2004",72,3,69,4.34782608695652
"3464","2/10/2005",69,5,64,7.8125
"3465","2/10/2006",70,8,62,12.9032258064516
"3466","2/10/2007",58,0,58,0
"3467","2/10/2008",123,3,120,2.5
"3468","2/10/2009",75,4,71,5.63380281690141
"3469","2/10/2010",71,2,69,2.89855072463768
"3470","2/10/2011",56,2,54,3.7037037037037
"3471","2/10/2012",66,3,63,4.76190476190476
"3472","2/10/2013",129,4,125,3.2
"3473","2/10/2014",73,1,72,1.38888888888889
"3474","2/10/2015",74,2,72,2.77777777777778
"3475","2/10/2016",72,1,71,1.40845070422535
"3476","2/10/2017",66,2,64,3.125
"3477","2/10/2018",58,4,54,7.40740740740741
"3478","2/10/2019",129,2,127,1.5748031496063
"3479","2/10/2020",74,4,70,5.71428571428571
"3480","2/10/2021",71,2,69,2.89855072463768
"3481","2/11/1994",74,1,73,1.36986301369863
"3482","2/11/1995",46,0,46,0
"3483","2/11/1996",122,2,120,1.66666666666667
"3484","2/11/1997",72,3,69,4.34782608695652
"3485","2/11/1998",73,1,72,1.38888888888889
"3486","2/11/1999",68,2,66,3.03030303030303
"3487","2/11/2000",61,5,56,8.92857142857143
"3488","2/11/2001",125,3,122,2.45901639344262
"3489","2/11/2002",75,0,75,0
"3490","2/11/2003",68,2,66,3.03030303030303
"3491","2/11/2004",73,1,72,1.38888888888889
"3492","2/11/2005",62,3,59,5.08474576271187
"3493","2/11/2006",59,3,56,5.35714285714286
"3494","2/11/2007",135,4,131,3.05343511450382
"3495","2/11/2008",71,1,70,1.42857142857143
"3496","2/11/2009",75,4,71,5.63380281690141
"3497","2/11/2010",76,4,72,5.55555555555556
"3498","2/11/2011",66,9,57,15.7894736842105
"3499","2/11/2012",37,2,35,5.71428571428571
"3500","2/11/2013",71,0,71,0
"3501","2/11/2014",69,0,69,0
"3502","2/11/2015",71,3,68,4.41176470588235
"3503","2/11/2016",71,10,61,16.3934426229508
"3504","2/11/2017",70,6,64,9.375
"3505","2/11/2018",130,8,122,6.55737704918033
"3506","2/11/2019",76,0,76,0
"3507","2/11/2020",70,0,70,0
"3508","2/11/2021",69,4,65,6.15384615384615
"3509","2/12/1994",55,2,53,3.77358490566038
"3510","2/12/1995",129,3,126,2.38095238095238
"3511","2/12/1996",74,0,74,0
"3512","2/12/1997",68,0,68,0
"3513","2/12/1998",74,4,70,5.71428571428571
"3514","2/12/1999",62,1,61,1.63934426229508
"3515","2/12/2000",55,1,54,1.85185185185185
"3516","2/12/2001",77,2,75,2.66666666666667
"3517","2/12/2002",71,3,68,4.41176470588235
"3518","2/12/2003",72,0,72,0
"3519","2/12/2004",69,1,68,1.47058823529412
"3520","2/12/2005",54,3,51,5.88235294117647
"3521","2/12/2006",128,7,121,5.78512396694215
"3522","2/12/2007",75,0,75,0
"3523","2/12/2008",73,2,71,2.8169014084507
"3524","2/12/2009",72,1,71,1.40845070422535
"3525","2/12/2010",57,5,52,9.61538461538462
"3526","2/12/2011",64,3,61,4.91803278688525
"3527","2/12/2012",120,3,117,2.56410256410256
"3528","2/12/2013",75,0,75,0
"3529","2/12/2014",61,1,60,1.66666666666667
"3530","2/12/2015",72,5,67,7.46268656716418
"3531","2/12/2016",68,5,63,7.93650793650794
"3532","2/12/2017",133,9,124,7.25806451612903
"3533","2/12/2018",72,0,72,0
"3534","2/12/2019",76,6,70,8.57142857142857
"3535","2/12/2020",67,1,66,1.51515151515152
"3536","2/12/2021",65,5,60,8.33333333333333
"3537","2/13/1994",124,8,116,6.89655172413793
"3538","2/13/1995",73,0,73,0
"3539","2/13/1996",74,1,73,1.36986301369863
"3540","2/13/1997",63,1,62,1.61290322580645
"3541","2/13/1998",61,0,61,0
"3542","2/13/1999",61,1,60,1.66666666666667
"3543","2/13/2000",135,2,133,1.50375939849624
"3544","2/13/2001",73,1,72,1.38888888888889
"3545","2/13/2002",71,4,67,5.97014925373134
"3546","2/13/2003",61,2,59,3.38983050847458
"3547","2/13/2004",66,1,65,1.53846153846154
"3548","2/13/2005",126,1,125,0.8
"3549","2/13/2006",74,0,74,0
"3550","2/13/2007",77,2,75,2.66666666666667
"3551","2/13/2008",73,2,71,2.8169014084507
"3552","2/13/2009",63,2,61,3.27868852459016
"3553","2/13/2010",64,3,61,4.91803278688525
"3554","2/13/2011",125,4,121,3.30578512396694
"3555","2/13/2012",76,0,76,0
"3556","2/13/2013",70,0,70,0
"3557","2/13/2014",69,3,66,4.54545454545455
"3558","2/13/2015",62,3,59,5.08474576271187
"3559","2/13/2016",59,5,54,9.25925925925926
"3560","2/13/2017",73,0,73,0
"3561","2/13/2018",78,5,73,6.84931506849315
"3562","2/13/2019",69,1,68,1.47058823529412
"3563","2/13/2020",74,2,72,2.77777777777778
"3564","2/13/2021",64,3,61,4.91803278688525
"3565","2/14/1994",69,0,69,0
"3566","2/14/1995",76,1,75,1.33333333333333
"3567","2/14/1996",74,0,74,0
"3568","2/14/1997",65,1,64,1.5625
"3569","2/14/1998",53,3,50,6
"3570","2/14/1999",123,2,121,1.65289256198347
"3571","2/14/2000",74,0,74,0
"3572","2/14/2001",74,3,71,4.22535211267606
"3573","2/14/2002",77,2,75,2.66666666666667
"3574","2/14/2003",69,3,66,4.54545454545455
"3575","2/14/2004",51,0,51,0
"3576","2/14/2005",77,0,77,0
"3577","2/14/2006",74,1,73,1.36986301369863
"3578","2/14/2007",71,0,71,0
"3579","2/14/2008",73,3,70,4.28571428571429
"3580","2/14/2009",59,1,58,1.72413793103448
"3581","2/14/2010",125,5,120,4.16666666666667
"3582","2/14/2011",70,0,70,0
"3583","2/14/2012",77,3,74,4.05405405405405
"3584","2/14/2013",71,3,68,4.41176470588235
"3585","2/14/2014",64,7,57,12.280701754386
"3586","2/14/2015",68,5,63,7.93650793650794
"3587","2/14/2016",128,9,119,7.56302521008403
"3588","2/14/2017",72,1,71,1.40845070422535
"3589","2/14/2018",60,4,56,7.14285714285714
"3590","2/14/2019",71,2,69,2.89855072463768
"3591","2/14/2020",64,2,62,3.2258064516129
"3592","2/14/2021",125,4,121,3.30578512396694
"3593","2/15/1994",64,1,63,1.58730158730159
"3594","2/15/1995",66,3,63,4.76190476190476
"3595","2/15/1996",67,0,67,0
"3596","2/15/1997",53,2,51,3.92156862745098
"3597","2/15/1998",124,2,122,1.63934426229508
"3598","2/15/1999",76,0,76,0
"3599","2/15/2000",67,1,66,1.51515151515152
"3600","2/15/2001",63,3,60,5
"3601","2/15/2002",65,2,63,3.17460317460317
"3602","2/15/2003",65,4,61,6.55737704918033
"3603","2/15/2004",119,1,118,0.847457627118644
"3604","2/15/2005",71,1,70,1.42857142857143
"3605","2/15/2006",69,2,67,2.98507462686567
"3606","2/15/2007",71,2,69,2.89855072463768
"3607","2/15/2008",49,2,47,4.25531914893617
"3608","2/15/2009",131,3,128,2.34375
"3609","2/15/2010",74,0,74,0
"3610","2/15/2011",74,4,70,5.71428571428571
"3611","2/15/2012",76,2,74,2.7027027027027
"3612","2/15/2013",56,5,51,9.80392156862745
"3613","2/15/2014",59,8,51,15.6862745098039
"3614","2/15/2015",127,6,121,4.95867768595041
"3615","2/15/2016",81,1,80,1.25
"3616","2/15/2017",74,4,70,5.71428571428571
"3617","2/15/2018",68,6,62,9.67741935483871
"3618","2/15/2019",60,2,58,3.44827586206897
"3619","2/15/2020",56,4,52,7.69230769230769
"3620","2/15/2021",75,0,75,0
"3621","2/16/1994",74,3,71,4.22535211267606
"3622","2/16/1995",64,2,62,3.2258064516129
"3623","2/16/1996",61,1,60,1.66666666666667
"3624","2/16/1997",119,6,113,5.30973451327434
"3625","2/16/1998",74,1,73,1.36986301369863
"3626","2/16/1999",74,2,72,2.77777777777778
"3627","2/16/2000",64,1,63,1.58730158730159
"3628","2/16/2001",58,2,56,3.57142857142857
"3629","2/16/2002",55,1,54,1.85185185185185
"3630","2/16/2003",123,0,123,0
"3631","2/16/2004",71,0,71,0
"3632","2/16/2005",74,1,73,1.36986301369863
"3633","2/16/2006",64,1,63,1.58730158730159
"3634","2/16/2007",58,1,57,1.75438596491228
"3635","2/16/2008",61,2,59,3.38983050847458
"3636","2/16/2009",72,0,72,0
"3637","2/16/2010",70,0,70,0
"3638","2/16/2011",65,2,63,3.17460317460317
"3639","2/16/2012",68,1,67,1.49253731343284
"3640","2/16/2013",56,4,52,7.69230769230769
"3641","2/16/2014",118,3,115,2.60869565217391
"3642","2/16/2015",76,0,76,0
"3643","2/16/2016",73,1,72,1.38888888888889
"3644","2/16/2017",67,1,66,1.51515151515152
"3645","2/16/2018",66,4,62,6.45161290322581
"3646","2/16/2019",64,3,61,4.91803278688525
"3647","2/16/2020",122,6,116,5.17241379310345
"3648","2/16/2021",73,0,73,0
"3649","2/17/1994",62,3,59,5.08474576271187
"3650","2/17/1995",71,1,70,1.42857142857143
"3651","2/17/1996",61,2,59,3.38983050847458
"3652","2/17/1997",69,0,69,0
"3653","2/17/1998",76,1,75,1.33333333333333
"3654","2/17/1999",73,3,70,4.28571428571429
"3655","2/17/2000",67,3,64,4.6875
"3656","2/17/2001",61,4,57,7.01754385964912
"3657","2/17/2002",145,4,141,2.83687943262411
"3658","2/17/2003",74,0,74,0
"3659","2/17/2004",73,0,73,0
"3660","2/17/2005",68,1,67,1.49253731343284
"3661","2/17/2006",57,1,56,1.78571428571429
"3662","2/17/2007",53,3,50,6
"3663","2/17/2008",122,4,118,3.38983050847458
"3664","2/17/2009",70,2,68,2.94117647058824
"3665","2/17/2010",67,2,65,3.07692307692308
"3666","2/17/2011",68,5,63,7.93650793650794
"3667","2/17/2012",66,2,64,3.125
"3668","2/17/2013",126,1,125,0.8
"3669","2/17/2014",74,0,74,0
"3670","2/17/2015",73,3,70,4.28571428571429
"3671","2/17/2016",67,3,64,4.6875
"3672","2/17/2017",60,4,56,7.14285714285714
"3673","2/17/2018",62,3,59,5.08474576271187
"3674","2/17/2019",126,0,126,0
"3675","2/17/2020",71,1,70,1.42857142857143
"3676","2/17/2021",71,1,70,1.42857142857143
"3677","2/18/1994",71,3,68,4.41176470588235
"3678","2/18/1995",62,1,61,1.63934426229508
"3679","2/18/1996",128,0,128,0
"3680","2/18/1997",71,1,70,1.42857142857143
"3681","2/18/1998",75,1,74,1.35135135135135
"3682","2/18/1999",64,4,60,6.66666666666667
"3683","2/18/2000",60,6,54,11.1111111111111
"3684","2/18/2001",127,3,124,2.41935483870968
"3685","2/18/2002",73,0,73,0
"3686","2/18/2003",72,0,72,0
"3687","2/18/2004",73,3,70,4.28571428571429
"3688","2/18/2005",62,2,60,3.33333333333333
"3689","2/18/2006",61,3,58,5.17241379310345
"3690","2/18/2007",129,6,123,4.8780487804878
"3691","2/18/2008",72,2,70,2.85714285714286
"3692","2/18/2009",73,1,72,1.38888888888889
"3693","2/18/2010",71,1,70,1.42857142857143
"3694","2/18/2011",56,7,49,14.2857142857143
"3695","2/18/2012",66,4,62,6.45161290322581
"3696","2/18/2013",70,1,69,1.44927536231884
"3697","2/18/2014",79,4,75,5.33333333333333
"3698","2/18/2015",68,1,67,1.49253731343284
"3699","2/18/2016",76,1,75,1.33333333333333
"3700","2/18/2017",66,3,63,4.76190476190476
"3701","2/18/2018",134,6,128,4.6875
"3702","2/18/2019",73,2,71,2.8169014084507
"3703","2/18/2020",74,2,72,2.77777777777778
"3704","2/18/2021",72,4,68,5.88235294117647
"3705","2/19/1994",52,0,52,0
"3706","2/19/1995",127,2,125,1.6
"3707","2/19/1996",76,1,75,1.33333333333333
"3708","2/19/1997",75,1,74,1.35135135135135
"3709","2/19/1998",69,1,68,1.47058823529412
"3710","2/19/1999",69,3,66,4.54545454545455
"3711","2/19/2000",63,1,62,1.61290322580645
"3712","2/19/2001",72,2,70,2.85714285714286
"3713","2/19/2002",74,0,74,0
"3714","2/19/2003",72,3,69,4.34782608695652
"3715","2/19/2004",73,1,72,1.38888888888889
"3716","2/19/2005",59,2,57,3.50877192982456
"3717","2/19/2006",134,8,126,6.34920634920635
"3718","2/19/2007",77,2,75,2.66666666666667
"3719","2/19/2008",71,0,71,0
"3720","2/19/2009",69,1,68,1.47058823529412
"3721","2/19/2010",61,4,57,7.01754385964912
"3722","2/19/2011",64,6,58,10.3448275862069
"3723","2/19/2012",129,6,123,4.8780487804878
"3724","2/19/2013",69,0,69,0
"3725","2/19/2014",72,3,69,4.34782608695652
"3726","2/19/2015",71,4,67,5.97014925373134
"3727","2/19/2016",68,4,64,6.25
"3728","2/19/2017",121,5,116,4.31034482758621
"3729","2/19/2018",73,0,73,0
"3730","2/19/2019",71,2,69,2.89855072463768
"3731","2/19/2020",75,2,73,2.73972602739726
"3732","2/19/2021",64,3,61,4.91803278688525
"3733","2/2/1994",71,0,71,0
"3734","2/2/1995",70,4,66,6.06060606060606
"3735","2/2/1996",63,1,62,1.61290322580645
"3736","2/2/1997",126,6,120,5
"3737","2/2/1998",77,0,77,0
"3738","2/2/1999",74,1,73,1.36986301369863
"3739","2/2/2000",75,4,71,5.63380281690141
"3740","2/2/2001",63,5,58,8.62068965517241
"3741","2/2/2002",69,2,67,2.98507462686567
"3742","2/2/2003",131,4,127,3.1496062992126
"3743","2/2/2004",76,1,75,1.33333333333333
"3744","2/2/2005",70,1,69,1.44927536231884
"3745","2/2/2006",62,5,57,8.7719298245614
"3746","2/2/2007",76,2,74,2.7027027027027
"3747","2/2/2008",63,1,62,1.61290322580645
"3748","2/2/2009",74,0,74,0
"3749","2/2/2010",76,3,73,4.10958904109589
"3750","2/2/2011",70,3,67,4.47761194029851
"3751","2/2/2012",70,2,68,2.94117647058824
"3752","2/2/2013",62,4,58,6.89655172413793
"3753","2/2/2014",131,5,126,3.96825396825397
"3754","2/2/2015",68,1,67,1.49253731343284
"3755","2/2/2016",73,2,71,2.8169014084507
"3756","2/2/2017",72,3,69,4.34782608695652
"3757","2/2/2018",63,0,63,0
"3758","2/2/2019",64,4,60,6.66666666666667
"3759","2/2/2020",130,5,125,4
"3760","2/2/2021",74,0,74,0
"3761","2/20/1994",131,2,129,1.55038759689922
"3762","2/20/1995",75,0,75,0
"3763","2/20/1996",73,2,71,2.8169014084507
"3764","2/20/1997",61,0,61,0
"3765","2/20/1998",65,1,64,1.5625
"3766","2/20/1999",68,2,66,3.03030303030303
"3767","2/20/2000",155,2,153,1.30718954248366
"3768","2/20/2001",73,0,73,0
"3769","2/20/2002",69,1,68,1.47058823529412
"3770","2/20/2003",71,2,69,2.89855072463768
"3771","2/20/2004",57,0,57,0
"3772","2/20/2005",125,1,124,0.806451612903226
"3773","2/20/2006",70,0,70,0
"3774","2/20/2007",73,1,72,1.38888888888889
"3775","2/20/2008",73,2,71,2.8169014084507
"3776","2/20/2009",57,2,55,3.63636363636364
"3777","2/20/2010",58,3,55,5.45454545454545
"3778","2/20/2011",117,2,115,1.73913043478261
"3779","2/20/2012",69,0,69,0
"3780","2/20/2013",76,5,71,7.04225352112676
"3781","2/20/2014",72,3,69,4.34782608695652
"3782","2/20/2015",60,6,54,11.1111111111111
"3783","2/20/2016",65,5,60,8.33333333333333
"3784","2/20/2017",78,2,76,2.63157894736842
"3785","2/20/2018",64,3,61,4.91803278688525
"3786","2/20/2019",68,0,68,0
"3787","2/20/2020",71,3,68,4.41176470588235
"3788","2/20/2021",62,4,58,6.89655172413793
"3789","2/21/1994",70,0,70,0
"3790","2/21/1995",69,2,67,2.98507462686567
"3791","2/21/1996",68,0,68,0
"3792","2/21/1997",69,2,67,2.98507462686567
"3793","2/21/1998",62,2,60,3.33333333333333
"3794","2/21/1999",122,7,115,6.08695652173913
"3795","2/21/2000",75,0,75,0
"3796","2/21/2001",73,4,69,5.79710144927536
"3797","2/21/2002",64,0,64,0
"3798","2/21/2003",61,2,59,3.38983050847458
"3799","2/21/2004",52,1,51,1.96078431372549
"3800","2/21/2005",73,1,72,1.38888888888889
"3801","2/21/2006",77,1,76,1.31578947368421
"3802","2/21/2007",69,4,65,6.15384615384615
"3803","2/21/2008",71,2,69,2.89855072463768
"3804","2/21/2009",50,6,44,13.6363636363636
"3805","2/21/2010",130,2,128,1.5625
"3806","2/21/2011",69,0,69,0
"3807","2/21/2012",72,2,70,2.85714285714286
"3808","2/21/2013",64,2,62,3.2258064516129
"3809","2/21/2014",55,7,48,14.5833333333333
"3810","2/21/2015",67,2,65,3.07692307692308
"3811","2/21/2016",123,6,117,5.12820512820513
"3812","2/21/2017",73,2,71,2.8169014084507
"3813","2/21/2018",76,2,74,2.7027027027027
"3814","2/21/2019",56,4,52,7.69230769230769
"3815","2/21/2020",58,2,56,3.57142857142857
"3816","2/21/2021",131,3,128,2.34375
"3817","2/22/1994",75,2,73,2.73972602739726
"3818","2/22/1995",64,0,64,0
"3819","2/22/1996",65,1,64,1.5625
"3820","2/22/1997",59,0,59,0
"3821","2/22/1998",123,2,121,1.65289256198347
"3822","2/22/1999",76,0,76,0
"3823","2/22/2000",73,1,72,1.38888888888889
"3824","2/22/2001",69,1,68,1.47058823529412
"3825","2/22/2002",63,4,59,6.77966101694915
"3826","2/22/2003",62,5,57,8.7719298245614
"3827","2/22/2004",129,3,126,2.38095238095238
"3828","2/22/2005",73,0,73,0
"3829","2/22/2006",74,1,73,1.36986301369863
"3830","2/22/2007",68,1,67,1.49253731343284
"3831","2/22/2008",62,4,58,6.89655172413793
"3832","2/22/2009",127,4,123,3.2520325203252
"3833","2/22/2010",76,0,76,0
"3834","2/22/2011",74,1,73,1.36986301369863
"3835","2/22/2012",70,1,69,1.44927536231884
"3836","2/22/2013",62,10,52,19.2307692307692
"3837","2/22/2014",64,7,57,12.280701754386
"3838","2/22/2015",130,5,125,4
"3839","2/22/2016",74,1,73,1.36986301369863
"3840","2/22/2017",75,2,73,2.73972602739726
"3841","2/22/2018",74,1,73,1.36986301369863
"3842","2/22/2019",65,3,62,4.83870967741935
"3843","2/22/2020",63,2,61,3.27868852459016
"3844","2/22/2021",75,0,75,0
"3845","2/23/1994",69,0,69,0
"3846","2/23/1995",74,1,73,1.36986301369863
"3847","2/23/1996",65,1,64,1.5625
"3848","2/23/1997",126,3,123,2.4390243902439
"3849","2/23/1998",68,0,68,0
"3850","2/23/1999",76,0,76,0
"3851","2/23/2000",76,0,76,0
"3852","2/23/2001",61,5,56,8.92857142857143
"3853","2/23/2002",66,2,64,3.125
"3854","2/23/2003",126,2,124,1.61290322580645
"3855","2/23/2004",77,1,76,1.31578947368421
"3856","2/23/2005",73,4,69,5.79710144927536
"3857","2/23/2006",73,2,71,2.8169014084507
"3858","2/23/2007",66,0,66,0
"3859","2/23/2008",68,3,65,4.61538461538462
"3860","2/23/2009",73,0,73,0
"3861","2/23/2010",74,1,73,1.36986301369863
"3862","2/23/2011",69,1,68,1.47058823529412
"3863","2/23/2012",77,2,75,2.66666666666667
"3864","2/23/2013",56,1,55,1.81818181818182
"3865","2/23/2014",131,6,125,4.8
"3866","2/23/2015",67,0,67,0
"3867","2/23/2016",73,6,67,8.95522388059701
"3868","2/23/2017",77,2,75,2.66666666666667
"3869","2/23/2018",67,5,62,8.06451612903226
"3870","2/23/2019",62,4,58,6.89655172413793
"3871","2/23/2020",129,5,124,4.03225806451613
"3872","2/23/2021",75,1,74,1.35135135135135
"3873","2/24/1994",74,0,74,0
"3874","2/24/1995",66,0,66,0
"3875","2/24/1996",62,4,58,6.89655172413793
"3876","2/24/1997",72,0,72,0
"3877","2/24/1998",75,1,74,1.35135135135135
"3878","2/24/1999",72,2,70,2.85714285714286
"3879","2/24/2000",66,7,59,11.864406779661
"3880","2/24/2001",64,1,63,1.58730158730159
"3881","2/24/2002",127,3,124,2.41935483870968
"3882","2/24/2003",75,0,75,0
"3883","2/24/2004",72,1,71,1.40845070422535
"3884","2/24/2005",61,3,58,5.17241379310345
"3885","2/24/2006",56,3,53,5.66037735849057
"3886","2/24/2007",51,2,49,4.08163265306122
"3887","2/24/2008",130,3,127,2.36220472440945
"3888","2/24/2009",77,1,76,1.31578947368421
"3889","2/24/2010",71,0,71,0
"3890","2/24/2011",67,4,63,6.34920634920635
"3891","2/24/2012",57,4,53,7.54716981132075
"3892","2/24/2013",131,7,124,5.64516129032258
"3893","2/24/2014",73,1,72,1.38888888888889
"3894","2/24/2015",70,1,69,1.44927536231884
"3895","2/24/2016",71,0,71,0
"3896","2/24/2017",63,1,62,1.61290322580645
"3897","2/24/2018",56,5,51,9.80392156862745
"3898","2/24/2019",123,3,120,2.5
"3899","2/24/2020",71,1,70,1.42857142857143
"3900","2/24/2021",73,4,69,5.79710144927536
"3901","2/25/1994",68,1,67,1.49253731343284
"3902","2/25/1995",64,6,58,10.3448275862069
"3903","2/25/1996",123,3,120,2.5
"3904","2/25/1997",70,0,70,0
"3905","2/25/1998",67,0,67,0
"3906","2/25/1999",65,2,63,3.17460317460317
"3907","2/25/2000",59,3,56,5.35714285714286
"3908","2/25/2001",131,6,125,4.8
"3909","2/25/2002",75,0,75,0
"3910","2/25/2003",71,0,71,0
"3911","2/25/2004",72,0,72,0
"3912","2/25/2005",57,1,56,1.78571428571429
"3913","2/25/2006",62,1,61,1.63934426229508
"3914","2/25/2007",128,5,123,4.0650406504065
"3915","2/25/2008",75,2,73,2.73972602739726
"3916","2/25/2009",72,1,71,1.40845070422535
"3917","2/25/2010",72,1,71,1.40845070422535
"3918","2/25/2011",60,4,56,7.14285714285714
"3919","2/25/2012",66,4,62,6.45161290322581
"3920","2/25/2013",71,0,71,0
"3921","2/25/2014",72,3,69,4.34782608695652
"3922","2/25/2015",61,1,60,1.66666666666667
"3923","2/25/2016",58,2,56,3.57142857142857
"3924","2/25/2017",57,6,51,11.7647058823529
"3925","2/25/2018",131,6,125,4.8
"3926","2/25/2019",73,2,71,2.8169014084507
"3927","2/25/2020",75,0,75,0
"3928","2/25/2021",72,3,69,4.34782608695652
"3929","2/26/1994",62,3,59,5.08474576271187
"3930","2/26/1995",126,4,122,3.27868852459016
"3931","2/26/1996",77,0,77,0
"3932","2/26/1997",73,1,72,1.38888888888889
"3933","2/26/1998",63,0,63,0
"3934","2/26/1999",68,5,63,7.93650793650794
"3935","2/26/2000",53,3,50,6
"3936","2/26/2001",76,2,74,2.7027027027027
"3937","2/26/2002",71,2,69,2.89855072463768
"3938","2/26/2003",72,5,67,7.46268656716418
"3939","2/26/2004",64,1,63,1.58730158730159
"3940","2/26/2005",61,2,59,3.38983050847458
"3941","2/26/2006",117,4,113,3.53982300884956
"3942","2/26/2007",72,1,71,1.40845070422535
"3943","2/26/2008",70,3,67,4.47761194029851
"3944","2/26/2009",68,0,68,0
"3945","2/26/2010",62,5,57,8.7719298245614
"3946","2/26/2011",62,2,60,3.33333333333333
"3947","2/26/2012",124,5,119,4.20168067226891
"3948","2/26/2013",69,0,69,0
"3949","2/26/2014",67,1,66,1.51515151515152
"3950","2/26/2015",65,6,59,10.1694915254237
"3951","2/26/2016",54,4,50,8
"3952","2/26/2017",122,0,122,0
"3953","2/26/2018",70,0,70,0
"3954","2/26/2019",75,3,72,4.16666666666667
"3955","2/26/2020",69,2,67,2.98507462686567
"3956","2/26/2021",59,3,56,5.35714285714286
"3957","2/27/1994",150,2,148,1.35135135135135
"3958","2/27/1995",75,0,75,0
"3959","2/27/1996",68,0,68,0
"3960","2/27/1997",66,0,66,0
"3961","2/27/1998",65,2,63,3.17460317460317
"3962","2/27/1999",61,2,59,3.38983050847458
"3963","2/27/2000",130,6,124,4.83870967741935
"3964","2/27/2001",72,0,72,0
"3965","2/27/2002",72,1,71,1.40845070422535
"3966","2/27/2003",72,3,69,4.34782608695652
"3967","2/27/2004",63,4,59,6.77966101694915
"3968","2/27/2005",121,5,116,4.31034482758621
"3969","2/27/2006",76,1,75,1.33333333333333
"3970","2/27/2007",72,0,72,0
"3971","2/27/2008",73,1,72,1.38888888888889
"3972","2/27/2009",54,3,51,5.88235294117647
"3973","2/27/2010",66,8,58,13.7931034482759
"3974","2/27/2011",123,7,116,6.03448275862069
"3975","2/27/2012",75,0,75,0
"3976","2/27/2013",75,1,74,1.35135135135135
"3977","2/27/2014",65,0,65,0
"3978","2/27/2015",54,2,52,3.84615384615385
"3979","2/27/2016",65,3,62,4.83870967741935
"3980","2/27/2017",74,1,73,1.36986301369863
"3981","2/27/2018",67,0,67,0
"3982","2/27/2019",70,3,67,4.47761194029851
"3983","2/27/2020",77,5,72,6.94444444444444
"3984","2/27/2021",65,5,60,8.33333333333333
"3985","2/28/1994",72,1,71,1.40845070422535
"3986","2/28/1995",74,1,73,1.36986301369863
"3987","2/28/1996",74,1,73,1.36986301369863
"3988","2/28/1997",60,4,56,7.14285714285714
"3989","2/28/1998",64,2,62,3.2258064516129
"3990","2/28/1999",126,4,122,3.27868852459016
"3991","2/28/2000",74,4,70,5.71428571428571
"3992","2/28/2001",69,3,66,4.54545454545455
"3993","2/28/2002",78,0,78,0
"3994","2/28/2003",57,4,53,7.54716981132075
"3995","2/28/2004",56,2,54,3.7037037037037
"3996","2/28/2005",74,0,74,0
"3997","2/28/2006",74,1,73,1.36986301369863
"3998","2/28/2007",66,1,65,1.53846153846154
"3999","2/28/2008",72,2,70,2.85714285714286
"4000","2/28/2009",56,0,56,0
"4001","2/28/2010",126,5,121,4.13223140495868
"4002","2/28/2011",71,0,71,0
"4003","2/28/2012",75,3,72,4.16666666666667
"4004","2/28/2013",64,1,63,1.58730158730159
"4005","2/28/2014",65,5,60,8.33333333333333
"4006","2/28/2015",66,4,62,6.45161290322581
"4007","2/28/2016",134,14,120,11.6666666666667
"4008","2/28/2017",73,1,72,1.38888888888889
"4009","2/28/2018",68,5,63,7.93650793650794
"4010","2/28/2019",65,0,65,0
"4011","2/28/2020",62,2,60,3.33333333333333
"4012","2/28/2021",132,11,121,9.09090909090909
"4013","2/29/1996",73,3,70,4.28571428571429
"4014","2/29/2000",71,1,70,1.42857142857143
"4015","2/29/2004",126,2,124,1.61290322580645
"4016","2/29/2008",58,5,53,9.43396226415094
"4017","2/29/2012",76,6,70,8.57142857142857
"4018","2/29/2016",76,0,76,0
"4019","2/29/2020",61,3,58,5.17241379310345
"4020","2/3/1994",63,0,63,0
"4021","2/3/1995",57,1,56,1.78571428571429
"4022","2/3/1996",63,0,63,0
"4023","2/3/1997",71,1,70,1.42857142857143
"4024","2/3/1998",70,2,68,2.94117647058824
"4025","2/3/1999",69,0,69,0
"4026","2/3/2000",72,1,71,1.40845070422535
"4027","2/3/2001",62,5,57,8.7719298245614
"4028","2/3/2002",133,7,126,5.55555555555556
"4029","2/3/2003",73,3,70,4.28571428571429
"4030","2/3/2004",72,0,72,0
"4031","2/3/2005",68,2,66,3.03030303030303
"4032","2/3/2006",60,2,58,3.44827586206897
"4033","2/3/2007",64,2,62,3.2258064516129
"4034","2/3/2008",118,2,116,1.72413793103448
"4035","2/3/2009",74,0,74,0
"4036","2/3/2010",73,1,72,1.38888888888889
"4037","2/3/2011",68,2,66,3.03030303030303
"4038","2/3/2012",68,2,66,3.03030303030303
"4039","2/3/2013",127,5,122,4.0983606557377
"4040","2/3/2014",73,0,73,0
"4041","2/3/2015",82,0,82,0
"4042","2/3/2016",76,6,70,8.57142857142857
"4043","2/3/2017",67,5,62,8.06451612903226
"4044","2/3/2018",46,3,43,6.97674418604651
"4045","2/3/2019",123,4,119,3.36134453781513
"4046","2/3/2020",75,1,74,1.35135135135135
"4047","2/3/2021",68,3,65,4.61538461538462
"4048","2/4/1994",54,5,49,10.2040816326531
"4049","2/4/1995",54,1,53,1.88679245283019
"4050","2/4/1996",124,7,117,5.98290598290598
"4051","2/4/1997",74,0,74,0
"4052","2/4/1998",68,3,65,4.61538461538462
"4053","2/4/1999",70,4,66,6.06060606060606
"4054","2/4/2000",66,1,65,1.53846153846154
"4055","2/4/2001",118,1,117,0.854700854700855
"4056","2/4/2002",74,0,74,0
"4057","2/4/2003",71,2,69,2.89855072463768
"4058","2/4/2004",72,0,72,0
"4059","2/4/2005",53,2,51,3.92156862745098
"4060","2/4/2006",68,2,66,3.03030303030303
"4061","2/4/2007",134,3,131,2.29007633587786
"4062","2/4/2008",76,0,76,0
"4063","2/4/2009",69,3,66,4.54545454545455
"4064","2/4/2010",78,3,75,4
"4065","2/4/2011",70,5,65,7.69230769230769
"4066","2/4/2012",63,2,61,3.27868852459016
"4067","2/4/2013",75,1,74,1.35135135135135
"4068","2/4/2014",75,0,75,0
"4069","2/4/2015",71,5,66,7.57575757575758
"4070","2/4/2016",65,6,59,10.1694915254237
"4071","2/4/2017",55,2,53,3.77358490566038
"4072","2/4/2018",129,4,125,3.2
"4073","2/4/2019",75,2,73,2.73972602739726
"4074","2/4/2020",70,0,70,0
"4075","2/4/2021",73,2,71,2.8169014084507
"4076","2/5/1994",67,0,67,0
"4077","2/5/1995",118,1,117,0.854700854700855
"4078","2/5/1996",75,1,74,1.35135135135135
"4079","2/5/1997",70,1,69,1.44927536231884
"4080","2/5/1998",74,3,71,4.22535211267606
"4081","2/5/1999",54,0,54,0
"4082","2/5/2000",64,2,62,3.2258064516129
"4083","2/5/2001",72,0,72,0
"4084","2/5/2002",75,2,73,2.73972602739726
"4085","2/5/2003",74,0,74,0
"4086","2/5/2004",72,2,70,2.85714285714286
"4087","2/5/2005",59,3,56,5.35714285714286
"4088","2/5/2006",125,3,122,2.45901639344262
"4089","2/5/2007",73,0,73,0
"4090","2/5/2008",73,0,73,0
"4091","2/5/2009",71,4,67,5.97014925373134
"4092","2/5/2010",56,3,53,5.66037735849057
"4093","2/5/2011",53,4,49,8.16326530612245
"4094","2/5/2012",123,6,117,5.12820512820513
"4095","2/5/2013",73,0,73,0
"4096","2/5/2014",73,1,72,1.38888888888889
"4097","2/5/2015",67,4,63,6.34920634920635
"4098","2/5/2016",68,3,65,4.61538461538462
"4099","2/5/2017",117,5,112,4.46428571428571
"4100","2/5/2018",75,0,75,0
"4101","2/5/2019",68,0,68,0
"4102","2/5/2020",63,5,58,8.62068965517241
"4103","2/5/2021",61,3,58,5.17241379310345
"4104","2/6/1994",132,4,128,3.125
"4105","2/6/1995",76,1,75,1.33333333333333
"4106","2/6/1996",73,0,73,0
"4107","2/6/1997",68,3,65,4.61538461538462
"4108","2/6/1998",68,1,67,1.49253731343284
"4109","2/6/1999",69,6,63,9.52380952380952
"4110","2/6/2000",127,8,119,6.72268907563025
"4111","2/6/2001",77,0,77,0
"4112","2/6/2002",68,4,64,6.25
"4113","2/6/2003",70,0,70,0
"4114","2/6/2004",61,0,61,0
"4115","2/6/2005",128,1,127,0.78740157480315
"4116","2/6/2006",71,0,71,0
"4117","2/6/2007",73,0,73,0
"4118","2/6/2008",70,0,70,0
"4119","2/6/2009",65,1,64,1.5625
"4120","2/6/2010",55,5,50,10
"4121","2/6/2011",130,6,124,4.83870967741935
"4122","2/6/2012",74,1,73,1.36986301369863
"4123","2/6/2013",75,3,72,4.16666666666667
"4124","2/6/2014",67,3,64,4.6875
"4125","2/6/2015",61,5,56,8.92857142857143
"4126","2/6/2016",59,4,55,7.27272727272727
"4127","2/6/2017",65,0,65,0
"4128","2/6/2018",70,1,69,1.44927536231884
"4129","2/6/2019",67,2,65,3.07692307692308
"4130","2/6/2020",64,4,60,6.66666666666667
"4131","2/6/2021",52,4,48,8.33333333333333
"4132","2/7/1994",73,1,72,1.38888888888889
"4133","2/7/1995",69,1,68,1.47058823529412
"4134","2/7/1996",66,1,65,1.53846153846154
"4135","2/7/1997",63,1,62,1.61290322580645
"4136","2/7/1998",60,3,57,5.26315789473684
"4137","2/7/1999",128,3,125,2.4
"4138","2/7/2000",73,0,73,0
"4139","2/7/2001",70,6,64,9.375
"4140","2/7/2002",60,0,60,0
"4141","2/7/2003",59,1,58,1.72413793103448
"4142","2/7/2004",52,2,50,4
"4143","2/7/2005",74,0,74,0
"4144","2/7/2006",70,2,68,2.94117647058824
"4145","2/7/2007",77,1,76,1.31578947368421
"4146","2/7/2008",71,0,71,0
"4147","2/7/2009",64,2,62,3.2258064516129
"4148","2/7/2010",145,3,142,2.11267605633803
"4149","2/7/2011",71,1,70,1.42857142857143
"4150","2/7/2012",72,5,67,7.46268656716418
"4151","2/7/2013",71,4,67,5.97014925373134
"4152","2/7/2014",61,4,57,7.01754385964912
"4153","2/7/2015",50,4,46,8.69565217391304
"4154","2/7/2016",127,9,118,7.6271186440678
"4155","2/7/2017",73,0,73,0
"4156","2/7/2018",73,6,67,8.95522388059701
"4157","2/7/2019",71,3,68,4.41176470588235
"4158","2/7/2020",63,1,62,1.61290322580645
"4159","2/7/2021",132,8,124,6.45161290322581
"4160","2/8/1994",67,3,64,4.6875
"4161","2/8/1995",72,0,72,0
"4162","2/8/1996",70,0,70,0
"4163","2/8/1997",67,0,67,0
"4164","2/8/1998",125,3,122,2.45901639344262
"4165","2/8/1999",78,1,77,1.2987012987013
"4166","2/8/2000",72,0,72,0
"4167","2/8/2001",73,4,69,5.79710144927536
"4168","2/8/2002",62,1,61,1.63934426229508
"4169","2/8/2003",58,3,55,5.45454545454545
"4170","2/8/2004",126,2,124,1.61290322580645
"4171","2/8/2005",69,0,69,0
"4172","2/8/2006",76,2,74,2.7027027027027
"4173","2/8/2007",65,1,64,1.5625
"4174","2/8/2008",61,7,54,12.962962962963
"4175","2/8/2009",131,8,123,6.50406504065041
"4176","2/8/2010",74,0,74,0
"4177","2/8/2011",71,3,68,4.41176470588235
"4178","2/8/2012",69,2,67,2.98507462686567
"4179","2/8/2013",64,4,60,6.66666666666667
"4180","2/8/2014",66,5,61,8.19672131147541
"4181","2/8/2015",120,7,113,6.19469026548673
"4182","2/8/2016",75,1,74,1.35135135135135
"4183","2/8/2017",68,2,66,3.03030303030303
"4184","2/8/2018",70,4,66,6.06060606060606
"4185","2/8/2019",63,2,61,3.27868852459016
"4186","2/8/2020",57,6,51,11.7647058823529
"4187","2/8/2021",76,0,76,0
"4188","2/9/1994",65,1,64,1.5625
"4189","2/9/1995",67,0,67,0
"4190","2/9/1996",66,0,66,0
"4191","2/9/1997",126,5,121,4.13223140495868
"4192","2/9/1998",73,0,73,0
"4193","2/9/1999",74,1,73,1.36986301369863
"4194","2/9/2000",68,0,68,0
"4195","2/9/2001",61,0,61,0
"4196","2/9/2002",60,5,55,9.09090909090909
"4197","2/9/2003",124,2,122,1.63934426229508
"4198","2/9/2004",74,0,74,0
"4199","2/9/2005",72,1,71,1.40845070422535
"4200","2/9/2006",66,3,63,4.76190476190476
"4201","2/9/2007",61,1,60,1.66666666666667
"4202","2/9/2008",62,2,60,3.33333333333333
"4203","2/9/2009",75,0,75,0
"4204","2/9/2010",72,0,72,0
"4205","2/9/2011",72,2,70,2.85714285714286
"4206","2/9/2012",58,0,58,0
"4207","2/9/2013",57,2,55,3.63636363636364
"4208","2/9/2014",130,5,125,4
"4209","2/9/2015",70,0,70,0
"4210","2/9/2016",77,5,72,6.94444444444444
"4211","2/9/2017",66,1,65,1.53846153846154
"4212","2/9/2018",66,5,61,8.19672131147541
"4213","2/9/2019",52,3,49,6.12244897959184
"4214","2/9/2020",136,2,134,1.49253731343284
"4215","2/9/2021",74,4,70,5.71428571428571
"4216","3/1/1994",76,1,75,1.33333333333333
"4217","3/1/1995",71,3,68,4.41176470588235
"4218","3/1/1996",63,1,62,1.61290322580645
"4219","3/1/1997",65,2,63,3.17460317460317
"4220","3/1/1998",121,2,119,1.68067226890756
"4221","3/1/1999",74,2,72,2.77777777777778
"4222","3/1/2000",66,2,64,3.125
"4223","3/1/2001",72,0,72,0
"4224","3/1/2002",57,5,52,9.61538461538462
"4225","3/1/2003",63,0,63,0
"4226","3/1/2004",77,0,77,0
"4227","3/1/2005",75,1,74,1.35135135135135
"4228","3/1/2006",74,2,72,2.77777777777778
"4229","3/1/2007",76,0,76,0
"4230","3/1/2008",59,7,52,13.4615384615385
"4231","3/1/2009",129,4,125,3.2
"4232","3/1/2010",73,1,72,1.38888888888889
"4233","3/1/2011",76,3,73,4.10958904109589
"4234","3/1/2012",67,3,64,4.6875
"4235","3/1/2013",63,2,61,3.27868852459016
"4236","3/1/2014",62,5,57,8.7719298245614
"4237","3/1/2015",129,7,122,5.73770491803279
"4238","3/1/2016",73,1,72,1.38888888888889
"4239","3/1/2017",67,2,65,3.07692307692308
"4240","3/1/2018",74,1,73,1.36986301369863
"4241","3/1/2019",65,3,62,4.83870967741935
"4242","3/1/2020",118,4,114,3.50877192982456
"4243","3/1/2021",75,3,72,4.16666666666667
"4244","3/10/1994",71,1,70,1.42857142857143
"4245","3/10/1995",60,0,60,0
"4246","3/10/1996",126,2,124,1.61290322580645
"4247","3/10/1997",77,0,77,0
"4248","3/10/1998",72,1,71,1.40845070422535
"4249","3/10/1999",76,1,75,1.33333333333333
"4250","3/10/2000",61,3,58,5.17241379310345
"4251","3/10/2001",65,3,62,4.83870967741935
"4252","3/10/2002",129,5,124,4.03225806451613
"4253","3/10/2003",76,0,76,0
"4254","3/10/2004",77,4,73,5.47945205479452
"4255","3/10/2005",67,4,63,6.34920634920635
"4256","3/10/2006",67,3,64,4.6875
"4257","3/10/2007",55,1,54,1.85185185185185
"4258","3/10/2008",76,1,75,1.33333333333333
"4259","3/10/2009",76,2,74,2.7027027027027
"4260","3/10/2010",69,2,67,2.98507462686567
"4261","3/10/2011",63,3,60,5
"4262","3/10/2012",57,1,56,1.78571428571429
"4263","3/10/2013",124,3,121,2.47933884297521
"4264","3/10/2014",77,0,77,0
"4265","3/10/2015",68,0,68,0
"4266","3/10/2016",74,2,72,2.77777777777778
"4267","3/10/2017",60,2,58,3.44827586206897
"4268","3/10/2018",53,3,50,6
"4269","3/10/2019",124,2,122,1.63934426229508
"4270","3/10/2020",69,2,67,2.98507462686567
"4271","3/10/2021",69,2,67,2.98507462686567
"4272","3/11/1994",68,1,67,1.49253731343284
"4273","3/11/1995",64,0,64,0
"4274","3/11/1996",77,0,77,0
"4275","3/11/1997",70,0,70,0
"4276","3/11/1998",74,3,71,4.22535211267606
"4277","3/11/1999",65,1,64,1.5625
"4278","3/11/2000",54,1,53,1.88679245283019
"4279","3/11/2001",126,10,116,8.62068965517241
"4280","3/11/2002",73,0,73,0
"4281","3/11/2003",73,1,72,1.38888888888889
"4282","3/11/2004",67,0,67,0
"4283","3/11/2005",47,2,45,4.44444444444444
"4284","3/11/2006",65,4,61,6.55737704918033
"4285","3/11/2007",131,1,130,0.769230769230769
"4286","3/11/2008",70,1,69,1.44927536231884
"4287","3/11/2009",69,4,65,6.15384615384615
"4288","3/11/2010",75,4,71,5.63380281690141
"4289","3/11/2011",63,0,63,0
"4290","3/11/2012",130,5,125,4
"4291","3/11/2013",74,0,74,0
"4292","3/11/2014",73,0,73,0
"4293","3/11/2015",74,3,71,4.22535211267606
"4294","3/11/2016",54,8,46,17.3913043478261
"4295","3/11/2017",62,4,58,6.89655172413793
"4296","3/11/2018",131,6,125,4.8
"4297","3/11/2019",74,0,74,0
"4298","3/11/2020",73,7,66,10.6060606060606
"4299","3/11/2021",69,1,68,1.47058823529412
"4300","3/12/1994",65,2,63,3.17460317460317
"4301","3/12/1995",151,1,150,0.666666666666667
"4302","3/12/1996",75,0,75,0
"4303","3/12/1997",75,0,75,0
"4304","3/12/1998",66,0,66,0
"4305","3/12/1999",60,0,60,0
"4306","3/12/2000",121,9,112,8.03571428571429
"4307","3/12/2001",75,0,75,0
"4308","3/12/2002",74,2,72,2.77777777777778
"4309","3/12/2003",71,2,69,2.89855072463768
"4310","3/12/2004",67,2,65,3.07692307692308
"4311","3/12/2005",54,2,52,3.84615384615385
"4312","3/12/2006",127,2,125,1.6
"4313","3/12/2007",71,0,71,0
"4314","3/12/2008",71,0,71,0
"4315","3/12/2009",68,4,64,6.25
"4316","3/12/2010",65,7,58,12.0689655172414
"4317","3/12/2011",56,3,53,5.66037735849057
"4318","3/12/2012",74,2,72,2.77777777777778
"4319","3/12/2013",72,0,72,0
"4320","3/12/2014",76,2,74,2.7027027027027
"4321","3/12/2015",75,4,71,5.63380281690141
"4322","3/12/2016",60,5,55,9.09090909090909
"4323","3/12/2017",128,8,120,6.66666666666667
"4324","3/12/2018",74,0,74,0
"4325","3/12/2019",75,3,72,4.16666666666667
"4326","3/12/2020",69,5,64,7.8125
"4327","3/12/2021",61,2,59,3.38983050847458
"4328","3/13/1994",126,2,124,1.61290322580645
"4329","3/13/1995",71,1,70,1.42857142857143
"4330","3/13/1996",70,1,69,1.44927536231884
"4331","3/13/1997",67,1,66,1.51515151515152
"4332","3/13/1998",66,1,65,1.53846153846154
"4333","3/13/1999",60,2,58,3.44827586206897
"4334","3/13/2000",76,0,76,0
"4335","3/13/2001",71,2,69,2.89855072463768
"4336","3/13/2002",74,0,74,0
"4337","3/13/2003",64,1,63,1.58730158730159
"4338","3/13/2004",61,2,59,3.38983050847458
"4339","3/13/2005",126,2,124,1.61290322580645
"4340","3/13/2006",73,0,73,0
"4341","3/13/2007",74,0,74,0
"4342","3/13/2008",71,3,68,4.41176470588235
"4343","3/13/2009",68,4,64,6.25
"4344","3/13/2010",54,8,46,17.3913043478261
"4345","3/13/2011",119,4,115,3.47826086956522
"4346","3/13/2012",78,2,76,2.63157894736842
"4347","3/13/2013",67,2,65,3.07692307692308
"4348","3/13/2014",69,5,64,7.8125
"4349","3/13/2015",64,4,60,6.66666666666667
"4350","3/13/2016",125,10,115,8.69565217391304
"4351","3/13/2017",77,0,77,0
"4352","3/13/2018",79,0,79,0
"4353","3/13/2019",76,1,75,1.33333333333333
"4354","3/13/2020",53,1,52,1.92307692307692
"4355","3/13/2021",62,0,62,0
"4356","3/14/1994",74,1,73,1.36986301369863
"4357","3/14/1995",63,4,59,6.77966101694915
"4358","3/14/1996",73,1,72,1.38888888888889
"4359","3/14/1997",69,2,67,2.98507462686567
"4360","3/14/1998",55,1,54,1.85185185185185
"4361","3/14/1999",119,0,119,0
"4362","3/14/2000",71,0,71,0
"4363","3/14/2001",74,1,73,1.36986301369863
"4364","3/14/2002",74,5,69,7.2463768115942
"4365","3/14/2003",66,3,63,4.76190476190476
"4366","3/14/2004",151,3,148,2.02702702702703
"4367","3/14/2005",72,0,72,0
"4368","3/14/2006",76,7,69,10.1449275362319
"4369","3/14/2007",69,0,69,0
"4370","3/14/2008",65,4,61,6.55737704918033
"4371","3/14/2009",63,7,56,12.5
"4372","3/14/2010",151,11,140,7.85714285714286
"4373","3/14/2011",71,2,69,2.89855072463768
"4374","3/14/2012",74,1,73,1.36986301369863
"4375","3/14/2013",65,2,63,3.17460317460317
"4376","3/14/2014",63,4,59,6.77966101694915
"4377","3/14/2015",58,4,54,7.40740740740741
"4378","3/14/2016",73,0,73,0
"4379","3/14/2017",72,3,69,4.34782608695652
"4380","3/14/2018",67,0,67,0
"4381","3/14/2019",73,1,72,1.38888888888889
"4382","3/14/2020",57,1,56,1.78571428571429
"4383","3/14/2021",130,3,127,2.36220472440945
"4384","3/15/1994",73,2,71,2.8169014084507
"4385","3/15/1995",70,1,69,1.44927536231884
"4386","3/15/1996",59,1,58,1.72413793103448
"4387","3/15/1997",66,1,65,1.53846153846154
"4388","3/15/1998",128,1,127,0.78740157480315
"4389","3/15/1999",73,1,72,1.38888888888889
"4390","3/15/2000",74,3,71,4.22535211267606
"4391","3/15/2001",67,1,66,1.51515151515152
"4392","3/15/2002",58,4,54,7.40740740740741
"4393","3/15/2003",62,3,59,5.08474576271187
"4394","3/15/2004",69,1,68,1.47058823529412
"4395","3/15/2005",76,3,73,4.10958904109589
"4396","3/15/2006",74,2,72,2.77777777777778
"4397","3/15/2007",67,2,65,3.07692307692308
"4398","3/15/2008",63,5,58,8.62068965517241
"4399","3/15/2009",120,3,117,2.56410256410256
"4400","3/15/2010",75,1,74,1.35135135135135
"4401","3/15/2011",73,0,73,0
"4402","3/15/2012",69,4,65,6.15384615384615
"4403","3/15/2013",51,2,49,4.08163265306122
"4404","3/15/2014",66,11,55,20
"4405","3/15/2015",110,3,107,2.80373831775701
"4406","3/15/2016",67,3,64,4.6875
"4407","3/15/2017",78,0,78,0
"4408","3/15/2018",63,2,61,3.27868852459016
"4409","3/15/2019",62,2,60,3.33333333333333
"4410","3/15/2020",126,4,122,3.27868852459016
"4411","3/15/2021",76,0,76,0
"4412","3/16/1994",64,1,63,1.58730158730159
"4413","3/16/1995",67,1,66,1.51515151515152
"4414","3/16/1996",59,1,58,1.72413793103448
"4415","3/16/1997",127,2,125,1.6
"4416","3/16/1998",75,0,75,0
"4417","3/16/1999",70,2,68,2.94117647058824
"4418","3/16/2000",66,0,66,0
"4419","3/16/2001",60,0,60,0
"4420","3/16/2002",62,1,61,1.63934426229508
"4421","3/16/2003",127,4,123,3.2520325203252
"4422","3/16/2004",71,1,70,1.42857142857143
"4423","3/16/2005",70,0,70,0
"4424","3/16/2006",71,2,69,2.89855072463768
"4425","3/16/2007",62,5,57,8.7719298245614
"4426","3/16/2008",123,4,119,3.36134453781513
"4427","3/16/2009",72,0,72,0
"4428","3/16/2010",73,3,70,4.28571428571429
"4429","3/16/2011",72,1,71,1.40845070422535
"4430","3/16/2012",61,2,59,3.38983050847458
"4431","3/16/2013",64,5,59,8.47457627118644
"4432","3/16/2014",124,8,116,6.89655172413793
"4433","3/16/2015",75,0,75,0
"4434","3/16/2016",71,1,70,1.42857142857143
"4435","3/16/2017",64,1,63,1.58730158730159
"4436","3/16/2018",62,3,59,5.08474576271187
"4437","3/16/2019",63,5,58,8.62068965517241
"4438","3/16/2020",70,1,69,1.44927536231884
"4439","3/16/2021",72,0,72,0
"4440","3/17/1994",66,1,65,1.53846153846154
"4441","3/17/1995",71,0,71,0
"4442","3/17/1996",120,6,114,5.26315789473684
"4443","3/17/1997",77,1,76,1.31578947368421
"4444","3/17/1998",67,0,67,0
"4445","3/17/1999",70,4,66,6.06060606060606
"4446","3/17/2000",67,2,65,3.07692307692308
"4447","3/17/2001",61,2,59,3.38983050847458
"4448","3/17/2002",127,5,122,4.0983606557377
"4449","3/17/2003",74,0,74,0
"4450","3/17/2004",71,0,71,0
"4451","3/17/2005",67,1,66,1.51515151515152
"4452","3/17/2006",62,2,60,3.33333333333333
"4453","3/17/2007",56,4,52,7.69230769230769
"4454","3/17/2008",73,2,71,2.8169014084507
"4455","3/17/2009",73,1,72,1.38888888888889
"4456","3/17/2010",66,1,65,1.53846153846154
"4457","3/17/2011",73,3,70,4.28571428571429
"4458","3/17/2012",58,3,55,5.45454545454545
"4459","3/17/2013",131,8,123,6.50406504065041
"4460","3/17/2014",74,0,74,0
"4461","3/17/2015",67,0,67,0
"4462","3/17/2016",70,1,69,1.44927536231884
"4463","3/17/2017",67,0,67,0
"4464","3/17/2018",58,4,54,7.40740740740741
"4465","3/17/2019",129,9,120,7.5
"4466","3/17/2020",73,1,72,1.38888888888889
"4467","3/17/2021",69,2,67,2.98507462686567
"4468","3/18/1994",60,2,58,3.44827586206897
"4469","3/18/1995",58,1,57,1.75438596491228
"4470","3/18/1996",71,0,71,0
"4471","3/18/1997",71,1,70,1.42857142857143
"4472","3/18/1998",80,1,79,1.26582278481013
"4473","3/18/1999",66,0,66,0
"4474","3/18/2000",64,2,62,3.2258064516129
"4475","3/18/2001",130,10,120,8.33333333333333
"4476","3/18/2002",70,0,70,0
"4477","3/18/2003",76,0,76,0
"4478","3/18/2004",70,2,68,2.94117647058824
"4479","3/18/2005",66,0,66,0
"4480","3/18/2006",52,1,51,1.96078431372549
"4481","3/18/2007",119,4,115,3.47826086956522
"4482","3/18/2008",76,1,75,1.33333333333333
"4483","3/18/2009",72,1,71,1.40845070422535
"4484","3/18/2010",65,2,63,3.17460317460317
"4485","3/18/2011",62,2,60,3.33333333333333
"4486","3/18/2012",147,8,139,5.75539568345324
"4487","3/18/2013",71,0,71,0
"4488","3/18/2014",73,5,68,7.35294117647059
"4489","3/18/2015",69,3,66,4.54545454545455
"4490","3/18/2016",58,1,57,1.75438596491228
"4491","3/18/2017",62,2,60,3.33333333333333
"4492","3/18/2018",126,1,125,0.8
"4493","3/18/2019",73,0,73,0
"4494","3/18/2020",71,1,70,1.42857142857143
"4495","3/18/2021",76,2,74,2.7027027027027
"4496","3/19/1994",62,2,60,3.33333333333333
"4497","3/19/1995",123,1,122,0.819672131147541
"4498","3/19/1996",74,1,73,1.36986301369863
"4499","3/19/1997",68,1,67,1.49253731343284
"4500","3/19/1998",75,8,67,11.9402985074627
"4501","3/19/1999",60,2,58,3.44827586206897
"4502","3/19/2000",131,4,127,3.1496062992126
"4503","3/19/2001",71,3,68,4.41176470588235
"4504","3/19/2002",72,2,70,2.85714285714286
"4505","3/19/2003",69,3,66,4.54545454545455
"4506","3/19/2004",59,3,56,5.35714285714286
"4507","3/19/2005",57,0,57,0
"4508","3/19/2006",124,5,119,4.20168067226891
"4509","3/19/2007",75,0,75,0
"4510","3/19/2008",73,1,72,1.38888888888889
"4511","3/19/2009",68,2,66,3.03030303030303
"4512","3/19/2010",66,7,59,11.864406779661
"4513","3/19/2011",59,3,56,5.35714285714286
"4514","3/19/2012",73,1,72,1.38888888888889
"4515","3/19/2013",74,2,72,2.77777777777778
"4516","3/19/2014",75,7,68,10.2941176470588
"4517","3/19/2015",71,4,67,5.97014925373134
"4518","3/19/2016",51,8,43,18.6046511627907
"4519","3/19/2017",136,3,133,2.25563909774436
"4520","3/19/2018",75,1,74,1.35135135135135
"4521","3/19/2019",79,1,78,1.28205128205128
"4522","3/19/2020",68,3,65,4.61538461538462
"4523","3/19/2021",65,7,58,12.0689655172414
"4524","3/2/1994",70,0,70,0
"4525","3/2/1995",72,4,68,5.88235294117647
"4526","3/2/1996",59,0,59,0
"4527","3/2/1997",136,4,132,3.03030303030303
"4528","3/2/1998",72,4,68,5.88235294117647
"4529","3/2/1999",75,0,75,0
"4530","3/2/2000",70,1,69,1.44927536231884
"4531","3/2/2001",61,2,59,3.38983050847458
"4532","3/2/2002",64,1,63,1.58730158730159
"4533","3/2/2003",132,1,131,0.763358778625954
"4534","3/2/2004",72,0,72,0
"4535","3/2/2005",74,5,69,7.2463768115942
"4536","3/2/2006",69,1,68,1.47058823529412
"4537","3/2/2007",63,2,61,3.27868852459016
"4538","3/2/2008",123,1,122,0.819672131147541
"4539","3/2/2009",75,2,73,2.73972602739726
"4540","3/2/2010",73,8,65,12.3076923076923
"4541","3/2/2011",73,4,69,5.79710144927536
"4542","3/2/2012",69,3,66,4.54545454545455
"4543","3/2/2013",66,7,59,11.864406779661
"4544","3/2/2014",127,5,122,4.0983606557377
"4545","3/2/2015",73,0,73,0
"4546","3/2/2016",75,1,74,1.35135135135135
"4547","3/2/2017",67,0,67,0
"4548","3/2/2018",66,4,62,6.45161290322581
"4549","3/2/2019",58,4,54,7.40740740740741
"4550","3/2/2020",72,1,71,1.40845070422535
"4551","3/2/2021",75,6,69,8.69565217391304
"4552","3/20/1994",132,2,130,1.53846153846154
"4553","3/20/1995",75,1,74,1.35135135135135
"4554","3/20/1996",65,0,65,0
"4555","3/20/1997",67,2,65,3.07692307692308
"4556","3/20/1998",63,9,54,16.6666666666667
"4557","3/20/1999",59,1,58,1.72413793103448
"4558","3/20/2000",76,2,74,2.7027027027027
"4559","3/20/2001",72,1,71,1.40845070422535
"4560","3/20/2002",67,5,62,8.06451612903226
"4561","3/20/2003",72,2,70,2.85714285714286
"4562","3/20/2004",57,2,55,3.63636363636364
"4563","3/20/2005",124,5,119,4.20168067226891
"4564","3/20/2006",72,0,72,0
"4565","3/20/2007",73,1,72,1.38888888888889
"4566","3/20/2008",69,7,62,11.2903225806452
"4567","3/20/2009",62,4,58,6.89655172413793
"4568","3/20/2010",45,2,43,4.65116279069767
"4569","3/20/2011",126,8,118,6.77966101694915
"4570","3/20/2012",67,0,67,0
"4571","3/20/2013",66,2,64,3.125
"4572","3/20/2014",73,1,72,1.38888888888889
"4573","3/20/2015",61,3,58,5.17241379310345
"4574","3/20/2016",119,8,111,7.20720720720721
"4575","3/20/2017",76,1,75,1.33333333333333
"4576","3/20/2018",66,2,64,3.125
"4577","3/20/2019",71,7,64,10.9375
"4578","3/20/2020",68,1,67,1.49253731343284
"4579","3/20/2021",63,5,58,8.62068965517241
"4580","3/21/1994",75,1,74,1.35135135135135
"4581","3/21/1995",73,0,73,0
"4582","3/21/1996",65,0,65,0
"4583","3/21/1997",60,4,56,7.14285714285714
"4584","3/21/1998",64,2,62,3.2258064516129
"4585","3/21/1999",126,1,125,0.8
"4586","3/21/2000",73,0,73,0
"4587","3/21/2001",73,1,72,1.38888888888889
"4588","3/21/2002",72,1,71,1.40845070422535
"4589","3/21/2003",63,2,61,3.27868852459016
"4590","3/21/2004",121,3,118,2.54237288135593
"4591","3/21/2005",74,0,74,0
"4592","3/21/2006",72,2,70,2.85714285714286
"4593","3/21/2007",73,2,71,2.8169014084507
"4594","3/21/2008",64,3,61,4.91803278688525
"4595","3/21/2009",64,3,61,4.91803278688525
"4596","3/21/2010",123,5,118,4.23728813559322
"4597","3/21/2011",72,1,71,1.40845070422535
"4598","3/21/2012",67,2,65,3.07692307692308
"4599","3/21/2013",70,8,62,12.9032258064516
"4600","3/21/2014",61,2,59,3.38983050847458
"4601","3/21/2015",66,9,57,15.7894736842105
"4602","3/21/2016",77,1,76,1.31578947368421
"4603","3/21/2017",71,3,68,4.41176470588235
"4604","3/21/2018",69,2,67,2.98507462686567
"4605","3/21/2019",67,1,66,1.51515151515152
"4606","3/21/2020",67,3,64,4.6875
"4607","3/21/2021",129,8,121,6.61157024793388
"4608","3/22/1994",73,0,73,0
"4609","3/22/1995",67,0,67,0
"4610","3/22/1996",56,2,54,3.7037037037037
"4611","3/22/1997",65,3,62,4.83870967741935
"4612","3/22/1998",127,5,122,4.0983606557377
"4613","3/22/1999",75,0,75,0
"4614","3/22/2000",75,5,70,7.14285714285714
"4615","3/22/2001",64,2,62,3.2258064516129
"4616","3/22/2002",65,4,61,6.55737704918033
"4617","3/22/2003",63,1,62,1.61290322580645
"4618","3/22/2004",77,2,75,2.66666666666667
"4619","3/22/2005",72,1,71,1.40845070422535
"4620","3/22/2006",77,4,73,5.47945205479452
"4621","3/22/2007",65,2,63,3.17460317460317
"4622","3/22/2008",45,2,43,4.65116279069767
"4623","3/22/2009",129,3,126,2.38095238095238
"4624","3/22/2010",77,1,76,1.31578947368421
"4625","3/22/2011",75,2,73,2.73972602739726
"4626","3/22/2012",66,5,61,8.19672131147541
"4627","3/22/2013",59,2,57,3.50877192982456
"4628","3/22/2014",67,2,65,3.07692307692308
"4629","3/22/2015",116,5,111,4.5045045045045
"4630","3/22/2016",77,1,76,1.31578947368421
"4631","3/22/2017",74,3,71,4.22535211267606
"4632","3/22/2018",68,2,66,3.03030303030303
"4633","3/22/2019",62,2,60,3.33333333333333
"4634","3/22/2020",124,5,119,4.20168067226891
"4635","3/22/2021",72,0,72,0
"4636","3/23/1994",66,2,64,3.125
"4637","3/23/1995",77,2,75,2.66666666666667
"4638","3/23/1996",64,0,64,0
"4639","3/23/1997",110,3,107,2.80373831775701
"4640","3/23/1998",76,1,75,1.33333333333333
"4641","3/23/1999",72,0,72,0
"4642","3/23/2000",72,4,68,5.88235294117647
"4643","3/23/2001",60,4,56,7.14285714285714
"4644","3/23/2002",67,6,61,9.83606557377049
"4645","3/23/2003",128,3,125,2.4
"4646","3/23/2004",71,1,70,1.42857142857143
"4647","3/23/2005",74,1,73,1.36986301369863
"4648","3/23/2006",66,0,66,0
"4649","3/23/2007",56,3,53,5.66037735849057
"4650","3/23/2008",128,2,126,1.58730158730159
"4651","3/23/2009",74,0,74,0
"4652","3/23/2010",74,1,73,1.36986301369863
"4653","3/23/2011",70,0,70,0
"4654","3/23/2012",63,5,58,8.62068965517241
"4655","3/23/2013",64,6,58,10.3448275862069
"4656","3/23/2014",126,11,115,9.56521739130435
"4657","3/23/2015",73,1,72,1.38888888888889
"4658","3/23/2016",66,1,65,1.53846153846154
"4659","3/23/2017",66,2,64,3.125
"4660","3/23/2018",58,5,53,9.43396226415094
"4661","3/23/2019",54,0,54,0
"4662","3/23/2020",71,2,69,2.89855072463768
"4663","3/23/2021",70,3,67,4.47761194029851
"4664","3/24/1994",64,1,63,1.58730158730159
"4665","3/24/1995",63,0,63,0
"4666","3/24/1996",157,0,157,0
"4667","3/24/1997",69,1,68,1.47058823529412
"4668","3/24/1998",76,0,76,0
"4669","3/24/1999",75,4,71,5.63380281690141
"4670","3/24/2000",61,1,60,1.66666666666667
"4671","3/24/2001",62,5,57,8.7719298245614
"4672","3/24/2002",126,5,121,4.13223140495868
"4673","3/24/2003",77,1,76,1.31578947368421
"4674","3/24/2004",73,5,68,7.35294117647059
"4675","3/24/2005",75,1,74,1.35135135135135
"4676","3/24/2006",60,3,57,5.26315789473684
"4677","3/24/2007",63,5,58,8.62068965517241
"4678","3/24/2008",73,1,72,1.38888888888889
"4679","3/24/2009",75,0,75,0
"4680","3/24/2010",76,0,76,0
"4681","3/24/2011",69,4,65,6.15384615384615
"4682","3/24/2012",65,4,61,6.55737704918033
"4683","3/24/2013",131,9,122,7.37704918032787
"4684","3/24/2014",73,1,72,1.38888888888889
"4685","3/24/2015",76,0,76,0
"4686","3/24/2016",70,7,63,11.1111111111111
"4687","3/24/2017",67,6,61,9.83606557377049
"4688","3/24/2018",50,6,44,13.6363636363636
"4689","3/24/2019",131,8,123,6.50406504065041
"4690","3/24/2020",74,2,72,2.77777777777778
"4691","3/24/2021",72,7,65,10.7692307692308
"4692","3/25/1994",71,0,71,0
"4693","3/25/1995",68,0,68,0
"4694","3/25/1996",72,0,72,0
"4695","3/25/1997",71,0,71,0
"4696","3/25/1998",72,1,71,1.40845070422535
"4697","3/25/1999",72,0,72,0
"4698","3/25/2000",65,3,62,4.83870967741935
"4699","3/25/2001",124,2,122,1.63934426229508
"4700","3/25/2002",74,3,71,4.22535211267606
"4701","3/25/2003",73,0,73,0
"4702","3/25/2004",68,2,66,3.03030303030303
"4703","3/25/2005",67,4,63,6.34920634920635
"4704","3/25/2006",55,4,51,7.84313725490196
"4705","3/25/2007",129,1,128,0.78125
"4706","3/25/2008",69,4,65,6.15384615384615
"4707","3/25/2009",66,1,65,1.53846153846154
"4708","3/25/2010",65,1,64,1.5625
"4709","3/25/2011",59,6,53,11.3207547169811
"4710","3/25/2012",124,7,117,5.98290598290598
"4711","3/25/2013",73,1,72,1.38888888888889
"4712","3/25/2014",70,2,68,2.94117647058824
"4713","3/25/2015",72,1,71,1.40845070422535
"4714","3/25/2016",65,4,61,6.55737704918033
"4715","3/25/2017",59,4,55,7.27272727272727
"4716","3/25/2018",129,5,124,4.03225806451613
"4717","3/25/2019",72,3,69,4.34782608695652
"4718","3/25/2020",72,5,67,7.46268656716418
"4719","3/25/2021",69,2,67,2.98507462686567
"4720","3/26/1994",55,2,53,3.77358490566038
"4721","3/26/1995",124,1,123,0.813008130081301
"4722","3/26/1996",73,1,72,1.38888888888889
"4723","3/26/1997",74,1,73,1.36986301369863
"4724","3/26/1998",70,1,69,1.44927536231884
"4725","3/26/1999",66,1,65,1.53846153846154
"4726","3/26/2000",114,3,111,2.7027027027027
"4727","3/26/2001",75,2,73,2.73972602739726
"4728","3/26/2002",74,0,74,0
"4729","3/26/2003",72,1,71,1.40845070422535
"4730","3/26/2004",62,1,61,1.63934426229508
"4731","3/26/2005",64,4,60,6.66666666666667
"4732","3/26/2006",122,3,119,2.52100840336134
"4733","3/26/2007",75,0,75,0
"4734","3/26/2008",73,1,72,1.38888888888889
"4735","3/26/2009",73,0,73,0
"4736","3/26/2010",57,4,53,7.54716981132075
"4737","3/26/2011",66,7,59,11.864406779661
"4738","3/26/2012",74,0,74,0
"4739","3/26/2013",74,2,72,2.77777777777778
"4740","3/26/2014",70,3,67,4.47761194029851
"4741","3/26/2015",63,3,60,5
"4742","3/26/2016",59,4,55,7.27272727272727
"4743","3/26/2017",130,5,125,4
"4744","3/26/2018",71,1,70,1.42857142857143
"4745","3/26/2019",73,1,72,1.38888888888889
"4746","3/26/2020",66,3,63,4.76190476190476
"4747","3/26/2021",61,3,58,5.17241379310345
"4748","3/27/1994",120,2,118,1.69491525423729
"4749","3/27/1995",76,0,76,0
"4750","3/27/1996",71,1,70,1.42857142857143
"4751","3/27/1997",65,3,62,4.83870967741935
"4752","3/27/1998",66,4,62,6.45161290322581
"4753","3/27/1999",68,0,68,0
"4754","3/27/2000",75,1,74,1.35135135135135
"4755","3/27/2001",75,2,73,2.73972602739726
"4756","3/27/2002",74,5,69,7.2463768115942
"4757","3/27/2003",75,2,73,2.73972602739726
"4758","3/27/2004",58,3,55,5.45454545454545
"4759","3/27/2005",126,4,122,3.27868852459016
"4760","3/27/2006",72,1,71,1.40845070422535
"4761","3/27/2007",72,0,72,0
"4762","3/27/2008",65,1,64,1.5625
"4763","3/27/2009",54,1,53,1.88679245283019
"4764","3/27/2010",63,5,58,8.62068965517241
"4765","3/27/2011",145,6,139,4.31654676258993
"4766","3/27/2012",75,4,71,5.63380281690141
"4767","3/27/2013",70,4,66,6.06060606060606
"4768","3/27/2014",70,7,63,11.1111111111111
"4769","3/27/2015",57,4,53,7.54716981132075
"4770","3/27/2016",126,5,121,4.13223140495868
"4771","3/27/2017",76,2,74,2.7027027027027
"4772","3/27/2018",66,4,62,6.45161290322581
"4773","3/27/2019",69,2,67,2.98507462686567
"4774","3/27/2020",63,2,61,3.27868852459016
"4775","3/27/2021",62,7,55,12.7272727272727
"4776","3/28/1994",67,1,66,1.51515151515152
"4777","3/28/1995",73,1,72,1.38888888888889
"4778","3/28/1996",69,0,69,0
"4779","3/28/1997",63,3,60,5
"4780","3/28/1998",52,2,50,4
"4781","3/28/1999",128,3,125,2.4
"4782","3/28/2000",71,0,71,0
"4783","3/28/2001",72,6,66,9.09090909090909
"4784","3/28/2002",69,3,66,4.54545454545455
"4785","3/28/2003",55,1,54,1.85185185185185
"4786","3/28/2004",130,4,126,3.17460317460317
"4787","3/28/2005",75,0,75,0
"4788","3/28/2006",72,1,71,1.40845070422535
"4789","3/28/2007",71,3,68,4.41176470588235
"4790","3/28/2008",60,4,56,7.14285714285714
"4791","3/28/2009",56,3,53,5.66037735849057
"4792","3/28/2010",127,4,123,3.2520325203252
"4793","3/28/2011",73,2,71,2.8169014084507
"4794","3/28/2012",74,3,71,4.22535211267606
"4795","3/28/2013",69,2,67,2.98507462686567
"4796","3/28/2014",61,1,60,1.66666666666667
"4797","3/28/2015",65,6,59,10.1694915254237
"4798","3/28/2016",72,0,72,0
"4799","3/28/2017",75,1,74,1.35135135135135
"4800","3/28/2018",63,2,61,3.27868852459016
"4801","3/28/2019",74,0,74,0
"4802","3/28/2020",58,1,57,1.75438596491228
"4803","3/28/2021",136,10,126,7.93650793650794
"4804","3/29/1994",69,2,67,2.98507462686567
"4805","3/29/1995",69,4,65,6.15384615384615
"4806","3/29/1996",70,4,66,6.06060606060606
"4807","3/29/1997",68,0,68,0
"4808","3/29/1998",128,3,125,2.4
"4809","3/29/1999",75,3,72,4.16666666666667
"4810","3/29/2000",71,1,70,1.42857142857143
"4811","3/29/2001",73,3,70,4.28571428571429
"4812","3/29/2002",65,3,62,4.83870967741935
"4813","3/29/2003",59,1,58,1.72413793103448
"4814","3/29/2004",74,2,72,2.77777777777778
"4815","3/29/2005",67,2,65,3.07692307692308
"4816","3/29/2006",74,1,73,1.36986301369863
"4817","3/29/2007",64,1,63,1.58730158730159
"4818","3/29/2008",65,8,57,14.0350877192982
"4819","3/29/2009",132,5,127,3.93700787401575
"4820","3/29/2010",75,0,75,0
"4821","3/29/2011",69,0,69,0
"4822","3/29/2012",75,6,69,8.69565217391304
"4823","3/29/2013",61,4,57,7.01754385964912
"4824","3/29/2014",64,6,58,10.3448275862069
"4825","3/29/2015",123,7,116,6.03448275862069
"4826","3/29/2016",75,2,73,2.73972602739726
"4827","3/29/2017",70,1,69,1.44927536231884
"4828","3/29/2018",67,2,65,3.07692307692308
"4829","3/29/2019",61,1,60,1.66666666666667
"4830","3/29/2020",129,3,126,2.38095238095238
"4831","3/29/2021",73,2,71,2.8169014084507
"4832","3/3/1994",71,4,67,5.97014925373134
"4833","3/3/1995",65,0,65,0
"4834","3/3/1996",122,7,115,6.08695652173913
"4835","3/3/1997",73,0,73,0
"4836","3/3/1998",74,1,73,1.36986301369863
"4837","3/3/1999",72,1,71,1.40845070422535
"4838","3/3/2000",65,1,64,1.5625
"4839","3/3/2001",69,5,64,7.8125
"4840","3/3/2002",125,5,120,4.16666666666667
"4841","3/3/2003",70,0,70,0
"4842","3/3/2004",74,1,73,1.36986301369863
"4843","3/3/2005",60,4,56,7.14285714285714
"4844","3/3/2006",62,2,60,3.33333333333333
"4845","3/3/2007",63,1,62,1.61290322580645
"4846","3/3/2008",74,0,74,0
"4847","3/3/2009",72,2,70,2.85714285714286
"4848","3/3/2010",73,0,73,0
"4849","3/3/2011",71,3,68,4.41176470588235
"4850","3/3/2012",54,3,51,5.88235294117647
"4851","3/3/2013",124,4,120,3.33333333333333
"4852","3/3/2014",71,3,68,4.41176470588235
"4853","3/3/2015",69,1,68,1.47058823529412
"4854","3/3/2016",64,5,59,8.47457627118644
"4855","3/3/2017",61,7,54,12.962962962963
"4856","3/3/2018",68,1,67,1.49253731343284
"4857","3/3/2019",125,4,121,3.30578512396694
"4858","3/3/2020",78,7,71,9.85915492957746
"4859","3/3/2021",66,0,66,0
"4860","3/30/1994",75,2,73,2.73972602739726
"4861","3/30/1995",67,1,66,1.51515151515152
"4862","3/30/1996",71,1,70,1.42857142857143
"4863","3/30/1997",128,0,128,0
"4864","3/30/1998",73,0,73,0
"4865","3/30/1999",73,1,72,1.38888888888889
"4866","3/30/2000",69,1,68,1.47058823529412
"4867","3/30/2001",62,2,60,3.33333333333333
"4868","3/30/2002",53,2,51,3.92156862745098
"4869","3/30/2003",125,2,123,1.6260162601626
"4870","3/30/2004",75,1,74,1.35135135135135
"4871","3/30/2005",75,1,74,1.35135135135135
"4872","3/30/2006",75,3,72,4.16666666666667
"4873","3/30/2007",64,3,61,4.91803278688525
"4874","3/30/2008",122,3,119,2.52100840336134
"4875","3/30/2009",73,0,73,0
"4876","3/30/2010",72,2,70,2.85714285714286
"4877","3/30/2011",67,0,67,0
"4878","3/30/2012",60,4,56,7.14285714285714
"4879","3/30/2013",67,6,61,9.83606557377049
"4880","3/30/2014",121,11,110,10
"4881","3/30/2015",70,0,70,0
"4882","3/30/2016",64,1,63,1.58730158730159
"4883","3/30/2017",67,3,64,4.6875
"4884","3/30/2018",56,3,53,5.66037735849057
"4885","3/30/2019",64,3,61,4.91803278688525
"4886","3/30/2020",78,0,78,0
"4887","3/30/2021",74,5,69,7.2463768115942
"4888","3/31/1994",67,1,66,1.51515151515152
"4889","3/31/1995",55,1,54,1.85185185185185
"4890","3/31/1996",122,2,120,1.66666666666667
"4891","3/31/1997",73,0,73,0
"4892","3/31/1998",68,2,66,3.03030303030303
"4893","3/31/1999",70,1,69,1.44927536231884
"4894","3/31/2000",65,7,58,12.0689655172414
"4895","3/31/2001",66,3,63,4.76190476190476
"4896","3/31/2002",132,6,126,4.76190476190476
"4897","3/31/2003",69,0,69,0
"4898","3/31/2004",75,2,73,2.73972602739726
"4899","3/31/2005",69,1,68,1.47058823529412
"4900","3/31/2006",65,4,61,6.55737704918033
"4901","3/31/2007",63,1,62,1.61290322580645
"4902","3/31/2008",73,0,73,0
"4903","3/31/2009",74,0,74,0
"4904","3/31/2010",71,1,70,1.42857142857143
"4905","3/31/2011",73,3,70,4.28571428571429
"4906","3/31/2012",68,4,64,6.25
"4907","3/31/2013",126,3,123,2.4390243902439
"4908","3/31/2014",69,0,69,0
"4909","3/31/2015",77,0,77,0
"4910","3/31/2016",65,4,61,6.55737704918033
"4911","3/31/2017",68,4,64,6.25
"4912","3/31/2018",66,4,62,6.45161290322581
"4913","3/31/2019",127,1,126,0.793650793650794
"4914","3/31/2020",71,2,69,2.89855072463768
"4915","3/31/2021",78,1,77,1.2987012987013
"4916","3/4/1994",65,2,63,3.17460317460317
"4917","3/4/1995",62,0,62,0
"4918","3/4/1996",73,0,73,0
"4919","3/4/1997",75,1,74,1.35135135135135
"4920","3/4/1998",67,0,67,0
"4921","3/4/1999",70,4,66,6.06060606060606
"4922","3/4/2000",65,1,64,1.5625
"4923","3/4/2001",125,4,121,3.30578512396694
"4924","3/4/2002",78,2,76,2.63157894736842
"4925","3/4/2003",70,0,70,0
"4926","3/4/2004",75,3,72,4.16666666666667
"4927","3/4/2005",57,3,54,5.55555555555556
"4928","3/4/2006",61,0,61,0
"4929","3/4/2007",131,4,127,3.1496062992126
"4930","3/4/2008",76,0,76,0
"4931","3/4/2009",61,1,60,1.66666666666667
"4932","3/4/2010",60,1,59,1.69491525423729
"4933","3/4/2011",57,6,51,11.7647058823529
"4934","3/4/2012",125,2,123,1.6260162601626
"4935","3/4/2013",70,0,70,0
"4936","3/4/2014",67,1,66,1.51515151515152
"4937","3/4/2015",73,1,72,1.38888888888889
"4938","3/4/2016",66,2,64,3.125
"4939","3/4/2017",66,6,60,10
"4940","3/4/2018",117,3,114,2.63157894736842
"4941","3/4/2019",73,2,71,2.8169014084507
"4942","3/4/2020",75,0,75,0
"4943","3/4/2021",74,6,68,8.82352941176471
"4944","3/5/1994",68,0,68,0
"4945","3/5/1995",126,3,123,2.4390243902439
"4946","3/5/1996",75,0,75,0
"4947","3/5/1997",73,1,72,1.38888888888889
"4948","3/5/1998",67,0,67,0
"4949","3/5/1999",68,1,67,1.49253731343284
"4950","3/5/2000",126,4,122,3.27868852459016
"4951","3/5/2001",69,2,67,2.98507462686567
"4952","3/5/2002",74,0,74,0
"4953","3/5/2003",74,0,74,0
"4954","3/5/2004",63,2,61,3.27868852459016
"4955","3/5/2005",64,0,64,0
"4956","3/5/2006",130,3,127,2.36220472440945
"4957","3/5/2007",73,0,73,0
"4958","3/5/2008",74,1,73,1.36986301369863
"4959","3/5/2009",63,4,59,6.77966101694915
"4960","3/5/2010",63,5,58,8.62068965517241
"4961","3/5/2011",57,1,56,1.78571428571429
"4962","3/5/2012",74,3,71,4.22535211267606
"4963","3/5/2013",71,2,69,2.89855072463768
"4964","3/5/2014",72,3,69,4.34782608695652
"4965","3/5/2015",67,2,65,3.07692307692308
"4966","3/5/2016",64,4,60,6.66666666666667
"4967","3/5/2017",130,7,123,5.69105691056911
"4968","3/5/2018",72,1,71,1.40845070422535
"4969","3/5/2019",74,3,71,4.22535211267606
"4970","3/5/2020",72,0,72,0
"4971","3/5/2021",67,3,64,4.6875
"4972","3/6/1994",126,1,125,0.8
"4973","3/6/1995",75,0,75,0
"4974","3/6/1996",72,0,72,0
"4975","3/6/1997",66,3,63,4.76190476190476
"4976","3/6/1998",61,2,59,3.38983050847458
"4977","3/6/1999",62,2,60,3.33333333333333
"4978","3/6/2000",75,0,75,0
"4979","3/6/2001",72,3,69,4.34782608695652
"4980","3/6/2002",74,4,70,5.71428571428571
"4981","3/6/2003",70,0,70,0
"4982","3/6/2004",63,4,59,6.77966101694915
"4983","3/6/2005",129,2,127,1.5748031496063
"4984","3/6/2006",72,2,70,2.85714285714286
"4985","3/6/2007",74,1,73,1.36986301369863
"4986","3/6/2008",71,0,71,0
"4987","3/6/2009",63,3,60,5
"4988","3/6/2010",64,2,62,3.2258064516129
"4989","3/6/2011",129,6,123,4.8780487804878
"4990","3/6/2012",73,0,73,0
"4991","3/6/2013",73,1,72,1.38888888888889
"4992","3/6/2014",74,2,72,2.77777777777778
"4993","3/6/2015",68,7,61,11.4754098360656
"4994","3/6/2016",131,8,123,6.50406504065041
"4995","3/6/2017",77,5,72,6.94444444444444
"4996","3/6/2018",69,3,66,4.54545454545455
"4997","3/6/2019",76,3,73,4.10958904109589
"4998","3/6/2020",61,5,56,8.92857142857143
"4999","3/6/2021",60,5,55,9.09090909090909
"5000","3/7/1994",68,1,67,1.49253731343284
"5001","3/7/1995",77,0,77,0
"5002","3/7/1996",72,4,68,5.88235294117647
"5003","3/7/1997",62,1,61,1.63934426229508
"5004","3/7/1998",61,2,59,3.38983050847458
"5005","3/7/1999",111,0,111,0
"5006","3/7/2000",72,2,70,2.85714285714286
"5007","3/7/2001",66,2,64,3.125
"5008","3/7/2002",65,2,63,3.17460317460317
"5009","3/7/2003",65,2,63,3.17460317460317
"5010","3/7/2004",128,0,128,0
"5011","3/7/2005",77,0,77,0
"5012","3/7/2006",70,2,68,2.94117647058824
"5013","3/7/2007",74,3,71,4.22535211267606
"5014","3/7/2008",55,5,50,10
"5015","3/7/2009",58,4,54,7.40740740740741
"5016","3/7/2010",129,7,122,5.73770491803279
"5017","3/7/2011",69,0,69,0
"5018","3/7/2012",69,1,68,1.47058823529412
"5019","3/7/2013",68,3,65,4.61538461538462
"5020","3/7/2014",65,6,59,10.1694915254237
"5021","3/7/2015",64,6,58,10.3448275862069
"5022","3/7/2016",68,2,66,3.03030303030303
"5023","3/7/2017",74,2,72,2.77777777777778
"5024","3/7/2018",68,4,64,6.25
"5025","3/7/2019",69,1,68,1.47058823529412
"5026","3/7/2020",66,1,65,1.53846153846154
"5027","3/7/2021",130,6,124,4.83870967741935
"5028","3/8/1994",71,1,70,1.42857142857143
"5029","3/8/1995",65,0,65,0
"5030","3/8/1996",57,0,57,0
"5031","3/8/1997",68,0,68,0
"5032","3/8/1998",128,1,127,0.78740157480315
"5033","3/8/1999",76,0,76,0
"5034","3/8/2000",75,1,74,1.35135135135135
"5035","3/8/2001",68,5,63,7.93650793650794
"5036","3/8/2002",67,6,61,9.83606557377049
"5037","3/8/2003",48,1,47,2.12765957446809
"5038","3/8/2004",71,0,71,0
"5039","3/8/2005",73,2,71,2.8169014084507
"5040","3/8/2006",73,2,71,2.8169014084507
"5041","3/8/2007",65,1,64,1.5625
"5042","3/8/2008",59,1,58,1.72413793103448
"5043","3/8/2009",132,3,129,2.32558139534884
"5044","3/8/2010",71,0,71,0
"5045","3/8/2011",74,0,74,0
"5046","3/8/2012",68,2,66,3.03030303030303
"5047","3/8/2013",60,5,55,9.09090909090909
"5048","3/8/2014",64,9,55,16.3636363636364
"5049","3/8/2015",131,7,124,5.64516129032258
"5050","3/8/2016",71,2,69,2.89855072463768
"5051","3/8/2017",71,2,69,2.89855072463768
"5052","3/8/2018",67,3,64,4.6875
"5053","3/8/2019",55,3,52,5.76923076923077
"5054","3/8/2020",128,3,125,2.4
"5055","3/8/2021",75,1,74,1.35135135135135
"5056","3/9/1994",71,0,71,0
"5057","3/9/1995",68,1,67,1.49253731343284
"5058","3/9/1996",62,1,61,1.63934426229508
"5059","3/9/1997",158,5,153,3.26797385620915
"5060","3/9/1998",77,0,77,0
"5061","3/9/1999",74,6,68,8.82352941176471
"5062","3/9/2000",68,2,66,3.03030303030303
"5063","3/9/2001",63,4,59,6.77966101694915
"5064","3/9/2002",63,5,58,8.62068965517241
"5065","3/9/2003",125,4,121,3.30578512396694
"5066","3/9/2004",73,2,71,2.8169014084507
"5067","3/9/2005",70,0,70,0
"5068","3/9/2006",61,3,58,5.17241379310345
"5069","3/9/2007",51,4,47,8.51063829787234
"5070","3/9/2008",127,5,122,4.0983606557377
"5071","3/9/2009",73,0,73,0
"5072","3/9/2010",65,1,64,1.5625
"5073","3/9/2011",73,1,72,1.38888888888889
"5074","3/9/2012",53,3,50,6
"5075","3/9/2013",63,4,59,6.77966101694915
"5076","3/9/2014",125,7,118,5.93220338983051
"5077","3/9/2015",75,1,74,1.35135135135135
"5078","3/9/2016",58,3,55,5.45454545454545
"5079","3/9/2017",65,4,61,6.55737704918033
"5080","3/9/2018",66,3,63,4.76190476190476
"5081","3/9/2019",50,4,46,8.69565217391304
"5082","3/9/2020",75,1,74,1.35135135135135
"5083","3/9/2021",76,1,75,1.33333333333333
"5084","4/1/1994",70,0,70,0
"5085","4/1/1995",73,3,70,4.28571428571429
"5086","4/1/1996",74,0,74,0
"5087","4/1/1997",72,0,72,0
"5088","4/1/1998",72,1,71,1.40845070422535
"5089","4/1/1999",69,5,64,7.8125
"5090","4/1/2000",67,0,67,0
"5091","4/1/2001",127,7,120,5.83333333333333
"5092","4/1/2002",76,1,75,1.33333333333333
"5093","4/1/2003",71,0,71,0
"5094","4/1/2004",58,2,56,3.57142857142857
"5095","4/1/2005",63,1,62,1.61290322580645
"5096","4/1/2006",74,1,73,1.36986301369863
"5097","4/1/2007",126,5,121,4.13223140495868
"5098","4/1/2008",64,0,64,0
"5099","4/1/2009",73,11,62,17.741935483871
"5100","4/1/2010",71,3,68,4.41176470588235
"5101","4/1/2011",71,2,69,2.89855072463768
"5102","4/1/2012",135,8,127,6.2992125984252
"5103","4/1/2013",72,0,72,0
"5104","4/1/2014",75,1,74,1.35135135135135
"5105","4/1/2015",74,5,69,7.2463768115942
"5106","4/1/2016",68,3,65,4.61538461538462
"5107","4/1/2017",73,1,72,1.38888888888889
"5108","4/1/2018",123,4,119,3.36134453781513
"5109","4/1/2019",67,1,66,1.51515151515152
"5110","4/1/2020",72,2,70,2.85714285714286
"5111","4/1/2021",66,4,62,6.45161290322581
"5112","4/10/1994",150,5,145,3.44827586206897
"5113","4/10/1995",72,0,72,0
"5114","4/10/1996",65,0,65,0
"5115","4/10/1997",63,0,63,0
"5116","4/10/1998",67,3,64,4.6875
"5117","4/10/1999",61,6,55,10.9090909090909
"5118","4/10/2000",75,2,73,2.73972602739726
"5119","4/10/2001",73,0,73,0
"5120","4/10/2002",71,7,64,10.9375
"5121","4/10/2003",62,4,58,6.89655172413793
"5122","4/10/2004",54,3,51,5.88235294117647
"5123","4/10/2005",149,3,146,2.05479452054794
"5124","4/10/2006",74,1,73,1.36986301369863
"5125","4/10/2007",72,1,71,1.40845070422535
"5126","4/10/2008",73,2,71,2.8169014084507
"5127","4/10/2009",59,0,59,0
"5128","4/10/2010",67,5,62,8.06451612903226
"5129","4/10/2011",123,1,122,0.819672131147541
"5130","4/10/2012",64,3,61,4.91803278688525
"5131","4/10/2013",75,1,74,1.35135135135135
"5132","4/10/2014",67,6,61,9.83606557377049
"5133","4/10/2015",58,6,52,11.5384615384615
"5134","4/10/2016",133,7,126,5.55555555555556
"5135","4/10/2017",77,0,77,0
"5136","4/10/2018",75,1,74,1.35135135135135
"5137","4/10/2019",66,2,64,3.125
"5138","4/10/2020",52,5,47,10.6382978723404
"5139","4/10/2021",66,3,63,4.76190476190476
"5140","4/11/1994",69,0,69,0
"5141","4/11/1995",73,0,73,0
"5142","4/11/1996",66,0,66,0
"5143","4/11/1997",63,1,62,1.61290322580645
"5144","4/11/1998",60,1,59,1.69491525423729
"5145","4/11/1999",125,2,123,1.6260162601626
"5146","4/11/2000",73,0,73,0
"5147","4/11/2001",71,3,68,4.41176470588235
"5148","4/11/2002",66,0,66,0
"5149","4/11/2003",68,4,64,6.25
"5150","4/11/2004",129,3,126,2.38095238095238
"5151","4/11/2005",76,0,76,0
"5152","4/11/2006",74,0,74,0
"5153","4/11/2007",65,2,63,3.17460317460317
"5154","4/11/2008",57,2,55,3.63636363636364
"5155","4/11/2009",55,1,54,1.85185185185185
"5156","4/11/2010",121,5,116,4.31034482758621
"5157","4/11/2011",69,0,69,0
"5158","4/11/2012",72,3,69,4.34782608695652
"5159","4/11/2013",77,3,74,4.05405405405405
"5160","4/11/2014",64,3,61,4.91803278688525
"5161","4/11/2015",64,9,55,16.3636363636364
"5162","4/11/2016",74,1,73,1.36986301369863
"5163","4/11/2017",67,2,65,3.07692307692308
"5164","4/11/2018",77,8,69,11.5942028985507
"5165","4/11/2019",63,3,60,5
"5166","4/11/2020",63,3,60,5
"5167","4/11/2021",125,9,116,7.75862068965517
"5168","4/12/1994",73,1,72,1.38888888888889
"5169","4/12/1995",69,0,69,0
"5170","4/12/1996",66,4,62,6.45161290322581
"5171","4/12/1997",59,3,56,5.35714285714286
"5172","4/12/1998",121,1,120,0.833333333333333
"5173","4/12/1999",74,0,74,0
"5174","4/12/2000",69,2,67,2.98507462686567
"5175","4/12/2001",74,3,71,4.22535211267606
"5176","4/12/2002",61,3,58,5.17241379310345
"5177","4/12/2003",59,1,58,1.72413793103448
"5178","4/12/2004",73,0,73,0
"5179","4/12/2005",71,0,71,0
"5180","4/12/2006",73,1,72,1.38888888888889
"5181","4/12/2007",65,1,64,1.5625
"5182","4/12/2008",50,1,49,2.04081632653061
"5183","4/12/2009",132,5,127,3.93700787401575
"5184","4/12/2010",73,0,73,0
"5185","4/12/2011",72,2,70,2.85714285714286
"5186","4/12/2012",70,4,66,6.06060606060606
"5187","4/12/2013",57,4,53,7.54716981132075
"5188","4/12/2014",60,2,58,3.44827586206897
"5189","4/12/2015",129,11,118,9.32203389830508
"5190","4/12/2016",75,0,75,0
"5191","4/12/2017",67,3,64,4.6875
"5192","4/12/2018",68,3,65,4.61538461538462
"5193","4/12/2019",67,1,66,1.51515151515152
"5194","4/12/2020",133,3,130,2.30769230769231
"5195","4/12/2021",72,2,70,2.85714285714286
"5196","4/13/1994",70,2,68,2.94117647058824
"5197","4/13/1995",66,0,66,0
"5198","4/13/1996",60,0,60,0
"5199","4/13/1997",124,3,121,2.47933884297521
"5200","4/13/1998",76,0,76,0
"5201","4/13/1999",76,1,75,1.33333333333333
"5202","4/13/2000",69,1,68,1.47058823529412
"5203","4/13/2001",58,4,54,7.40740740740741
"5204","4/13/2002",68,5,63,7.93650793650794
"5205","4/13/2003",130,0,130,0
"5206","4/13/2004",72,0,72,0
"5207","4/13/2005",74,1,73,1.36986301369863
"5208","4/13/2006",72,0,72,0
"5209","4/13/2007",62,2,60,3.33333333333333
"5210","4/13/2008",122,2,120,1.66666666666667
"5211","4/13/2009",70,1,69,1.44927536231884
"5212","4/13/2010",71,0,71,0
"5213","4/13/2011",64,5,59,8.47457627118644
"5214","4/13/2012",59,2,57,3.50877192982456
"5215","4/13/2013",67,8,59,13.5593220338983
"5216","4/13/2014",128,9,119,7.56302521008403
"5217","4/13/2015",73,5,68,7.35294117647059
"5218","4/13/2016",70,2,68,2.94117647058824
"5219","4/13/2017",68,2,66,3.03030303030303
"5220","4/13/2018",42,2,40,5
"5221","4/13/2019",67,6,61,9.83606557377049
"5222","4/13/2020",76,1,75,1.33333333333333
"5223","4/13/2021",72,1,71,1.40845070422535
"5224","4/14/1994",72,3,69,4.34782608695652
"5225","4/14/1995",49,1,48,2.08333333333333
"5226","4/14/1996",126,5,121,4.13223140495868
"5227","4/14/1997",75,0,75,0
"5228","4/14/1998",73,0,73,0
"5229","4/14/1999",72,0,72,0
"5230","4/14/2000",65,4,61,6.55737704918033
"5231","4/14/2001",60,2,58,3.44827586206897
"5232","4/14/2002",128,5,123,4.0650406504065
"5233","4/14/2003",76,0,76,0
"5234","4/14/2004",72,3,69,4.34782608695652
"5235","4/14/2005",67,0,67,0
"5236","4/14/2006",63,1,62,1.61290322580645
"5237","4/14/2007",51,4,47,8.51063829787234
"5238","4/14/2008",77,1,76,1.31578947368421
"5239","4/14/2009",73,0,73,0
"5240","4/14/2010",71,2,69,2.89855072463768
"5241","4/14/2011",73,1,72,1.38888888888889
"5242","4/14/2012",56,2,54,3.7037037037037
"5243","4/14/2013",128,5,123,4.0650406504065
"5244","4/14/2014",73,0,73,0
"5245","4/14/2015",76,3,73,4.10958904109589
"5246","4/14/2016",69,3,66,4.54545454545455
"5247","4/14/2017",66,9,57,15.7894736842105
"5248","4/14/2018",57,3,54,5.55555555555556
"5249","4/14/2019",138,4,134,2.98507462686567
"5250","4/14/2020",77,1,76,1.31578947368421
"5251","4/14/2021",77,5,72,6.94444444444444
"5252","4/15/1994",68,2,66,3.03030303030303
"5253","4/15/1995",57,1,56,1.78571428571429
"5254","4/15/1996",77,0,77,0
"5255","4/15/1997",73,0,73,0
"5256","4/15/1998",71,3,68,4.41176470588235
"5257","4/15/1999",68,0,68,0
"5258","4/15/2000",58,0,58,0
"5259","4/15/2001",127,2,125,1.6
"5260","4/15/2002",75,0,75,0
"5261","4/15/2003",75,2,73,2.73972602739726
"5262","4/15/2004",70,2,68,2.94117647058824
"5263","4/15/2005",68,2,66,3.03030303030303
"5264","4/15/2006",54,0,54,0
"5265","4/15/2007",123,4,119,3.36134453781513
"5266","4/15/2008",77,0,77,0
"5267","4/15/2009",67,0,67,0
"5268","4/15/2010",69,6,63,9.52380952380952
"5269","4/15/2011",59,2,57,3.50877192982456
"5270","4/15/2012",160,11,149,7.38255033557047
"5271","4/15/2013",72,3,69,4.34782608695652
"5272","4/15/2014",75,0,75,0
"5273","4/15/2015",67,1,66,1.51515151515152
"5274","4/15/2016",68,6,62,9.67741935483871
"5275","4/15/2017",64,2,62,3.2258064516129
"5276","4/15/2018",125,6,119,5.04201680672269
"5277","4/15/2019",76,2,74,2.7027027027027
"5278","4/15/2020",74,0,74,0
"5279","4/15/2021",72,1,71,1.40845070422535
"5280","4/16/1994",67,1,66,1.51515151515152
"5281","4/16/1995",117,1,116,0.862068965517241
"5282","4/16/1996",74,0,74,0
"5283","4/16/1997",71,1,70,1.42857142857143
"5284","4/16/1998",65,2,63,3.17460317460317
"5285","4/16/1999",62,4,58,6.89655172413793
"5286","4/16/2000",128,11,117,9.4017094017094
"5287","4/16/2001",76,1,75,1.33333333333333
"5288","4/16/2002",76,0,76,0
"5289","4/16/2003",71,2,69,2.89855072463768
"5290","4/16/2004",63,4,59,6.77966101694915
"5291","4/16/2005",68,2,66,3.03030303030303
"5292","4/16/2006",118,1,117,0.854700854700855
"5293","4/16/2007",74,1,73,1.36986301369863
"5294","4/16/2008",75,2,73,2.73972602739726
"5295","4/16/2009",73,1,72,1.38888888888889
"5296","4/16/2010",55,1,54,1.85185185185185
"5297","4/16/2011",64,6,58,10.3448275862069
"5298","4/16/2012",75,0,75,0
"5299","4/16/2013",69,2,67,2.98507462686567
"5300","4/16/2014",77,1,76,1.31578947368421
"5301","4/16/2015",72,3,69,4.34782608695652
"5302","4/16/2016",57,4,53,7.54716981132075
"5303","4/16/2017",132,10,122,8.19672131147541
"5304","4/16/2018",72,1,71,1.40845070422535
"5305","4/16/2019",71,2,69,2.89855072463768
"5306","4/16/2020",82,5,77,6.49350649350649
"5307","4/16/2021",64,2,62,3.2258064516129
"5308","4/17/1994",125,1,124,0.806451612903226
"5309","4/17/1995",70,0,70,0
"5310","4/17/1996",70,0,70,0
"5311","4/17/1997",67,0,67,0
"5312","4/17/1998",62,2,60,3.33333333333333
"5313","4/17/1999",60,5,55,9.09090909090909
"5314","4/17/2000",74,1,73,1.36986301369863
"5315","4/17/2001",71,3,68,4.41176470588235
"5316","4/17/2002",73,4,69,5.79710144927536
"5317","4/17/2003",70,2,68,2.94117647058824
"5318","4/17/2004",66,8,58,13.7931034482759
"5319","4/17/2005",118,2,116,1.72413793103448
"5320","4/17/2006",70,2,68,2.94117647058824
"5321","4/17/2007",73,0,73,0
"5322","4/17/2008",68,5,63,7.93650793650794
"5323","4/17/2009",56,1,55,1.81818181818182
"5324","4/17/2010",62,6,56,10.7142857142857
"5325","4/17/2011",128,8,120,6.66666666666667
"5326","4/17/2012",74,1,73,1.36986301369863
"5327","4/17/2013",70,3,67,4.47761194029851
"5328","4/17/2014",68,2,66,3.03030303030303
"5329","4/17/2015",69,4,65,6.15384615384615
"5330","4/17/2016",130,8,122,6.55737704918033
"5331","4/17/2017",68,1,67,1.49253731343284
"5332","4/17/2018",73,2,71,2.8169014084507
"5333","4/17/2019",70,2,68,2.94117647058824
"5334","4/17/2020",65,4,61,6.55737704918033
"5335","4/17/2021",63,5,58,8.62068965517241
"5336","4/18/1994",64,0,64,0
"5337","4/18/1995",67,1,66,1.51515151515152
"5338","4/18/1996",63,0,63,0
"5339","4/18/1997",63,2,61,3.27868852459016
"5340","4/18/1998",60,0,60,0
"5341","4/18/1999",161,8,153,5.22875816993464
"5342","4/18/2000",65,0,65,0
"5343","4/18/2001",74,2,72,2.77777777777778
"5344","4/18/2002",68,0,68,0
"5345","4/18/2003",63,2,61,3.27868852459016
"5346","4/18/2004",126,1,125,0.8
"5347","4/18/2005",77,0,77,0
"5348","4/18/2006",74,0,74,0
"5349","4/18/2007",72,2,70,2.85714285714286
"5350","4/18/2008",65,2,63,3.17460317460317
"5351","4/18/2009",57,1,56,1.78571428571429
"5352","4/18/2010",129,4,125,3.2
"5353","4/18/2011",74,0,74,0
"5354","4/18/2012",77,1,76,1.31578947368421
"5355","4/18/2013",70,5,65,7.69230769230769
"5356","4/18/2014",64,3,61,4.91803278688525
"5357","4/18/2015",61,4,57,7.01754385964912
"5358","4/18/2016",76,0,76,0
"5359","4/18/2017",77,0,77,0
"5360","4/18/2018",70,2,68,2.94117647058824
"5361","4/18/2019",72,7,65,10.7692307692308
"5362","4/18/2020",56,4,52,7.69230769230769
"5363","4/18/2021",120,4,116,3.44827586206897
"5364","4/19/1994",64,1,63,1.58730158730159
"5365","4/19/1995",74,0,74,0
"5366","4/19/1996",66,2,64,3.125
"5367","4/19/1997",63,2,61,3.27868852459016
"5368","4/19/1998",125,4,121,3.30578512396694
"5369","4/19/1999",75,0,75,0
"5370","4/19/2000",70,2,68,2.94117647058824
"5371","4/19/2001",65,0,65,0
"5372","4/19/2002",61,3,58,5.17241379310345
"5373","4/19/2003",56,4,52,7.69230769230769
"5374","4/19/2004",75,0,75,0
"5375","4/19/2005",72,0,72,0
"5376","4/19/2006",74,3,71,4.22535211267606
"5377","4/19/2007",71,4,67,5.97014925373134
"5378","4/19/2008",63,5,58,8.62068965517241
"5379","4/19/2009",130,7,123,5.69105691056911
"5380","4/19/2010",75,0,75,0
"5381","4/19/2011",74,0,74,0
"5382","4/19/2012",64,1,63,1.58730158730159
"5383","4/19/2013",61,5,56,8.92857142857143
"5384","4/19/2014",59,3,56,5.35714285714286
"5385","4/19/2015",130,3,127,2.36220472440945
"5386","4/19/2016",74,3,71,4.22535211267606
"5387","4/19/2017",68,2,66,3.03030303030303
"5388","4/19/2018",72,2,70,2.85714285714286
"5389","4/19/2019",62,3,59,5.08474576271187
"5390","4/19/2020",131,9,122,7.37704918032787
"5391","4/19/2021",77,1,76,1.31578947368421
"5392","4/2/1994",55,4,51,7.84313725490196
"5393","4/2/1995",126,2,124,1.61290322580645
"5394","4/2/1996",75,0,75,0
"5395","4/2/1997",72,3,69,4.34782608695652
"5396","4/2/1998",66,4,62,6.45161290322581
"5397","4/2/1999",56,0,56,0
"5398","4/2/2000",127,5,122,4.0983606557377
"5399","4/2/2001",72,0,72,0
"5400","4/2/2002",72,0,72,0
"5401","4/2/2003",72,1,71,1.40845070422535
"5402","4/2/2004",61,4,57,7.01754385964912
"5403","4/2/2005",40,2,38,5.26315789473684
"5404","4/2/2006",128,13,115,11.304347826087
"5405","4/2/2007",73,1,72,1.38888888888889
"5406","4/2/2008",74,2,72,2.77777777777778
"5407","4/2/2009",72,4,68,5.88235294117647
"5408","4/2/2010",58,2,56,3.57142857142857
"5409","4/2/2011",61,3,58,5.17241379310345
"5410","4/2/2012",72,1,71,1.40845070422535
"5411","4/2/2013",72,1,71,1.40845070422535
"5412","4/2/2014",69,2,67,2.98507462686567
"5413","4/2/2015",51,4,47,8.51063829787234
"5414","4/2/2016",64,1,63,1.58730158730159
"5415","4/2/2017",129,7,122,5.73770491803279
"5416","4/2/2018",76,0,76,0
"5417","4/2/2019",70,3,67,4.47761194029851
"5418","4/2/2020",73,3,70,4.28571428571429
"5419","4/2/2021",66,4,62,6.45161290322581
"5420","4/20/1994",70,1,69,1.44927536231884
"5421","4/20/1995",62,2,60,3.33333333333333
"5422","4/20/1996",63,2,61,3.27868852459016
"5423","4/20/1997",121,2,119,1.68067226890756
"5424","4/20/1998",73,0,73,0
"5425","4/20/1999",74,1,73,1.36986301369863
"5426","4/20/2000",72,2,70,2.85714285714286
"5427","4/20/2001",60,2,58,3.44827586206897
"5428","4/20/2002",61,2,59,3.38983050847458
"5429","4/20/2003",130,5,125,4
"5430","4/20/2004",73,0,73,0
"5431","4/20/2005",74,6,68,8.82352941176471
"5432","4/20/2006",65,1,64,1.5625
"5433","4/20/2007",63,3,60,5
"5434","4/20/2008",153,5,148,3.37837837837838
"5435","4/20/2009",75,3,72,4.16666666666667
"5436","4/20/2010",66,0,66,0
"5437","4/20/2011",72,2,70,2.85714285714286
"5438","4/20/2012",62,7,55,12.7272727272727
"5439","4/20/2013",59,1,58,1.72413793103448
"5440","4/20/2014",125,8,117,6.83760683760684
"5441","4/20/2015",72,1,71,1.40845070422535
"5442","4/20/2016",69,2,67,2.98507462686567
"5443","4/20/2017",68,5,63,7.93650793650794
"5444","4/20/2018",64,3,61,4.91803278688525
"5445","4/20/2019",54,3,51,5.88235294117647
"5446","4/20/2020",74,0,74,0
"5447","4/20/2021",75,2,73,2.73972602739726
"5448","4/21/1994",70,2,68,2.94117647058824
"5449","4/21/1995",61,3,58,5.17241379310345
"5450","4/21/1996",123,0,123,0
"5451","4/21/1997",72,0,72,0
"5452","4/21/1998",73,2,71,2.8169014084507
"5453","4/21/1999",69,1,68,1.47058823529412
"5454","4/21/2000",56,5,51,9.80392156862745
"5455","4/21/2001",61,3,58,5.17241379310345
"5456","4/21/2002",122,4,118,3.38983050847458
"5457","4/21/2003",74,2,72,2.77777777777778
"5458","4/21/2004",68,0,68,0
"5459","4/21/2005",62,1,61,1.63934426229508
"5460","4/21/2006",57,3,54,5.55555555555556
"5461","4/21/2007",55,3,52,5.76923076923077
"5462","4/21/2008",75,0,75,0
"5463","4/21/2009",72,0,72,0
"5464","4/21/2010",74,1,73,1.36986301369863
"5465","4/21/2011",68,2,66,3.03030303030303
"5466","4/21/2012",65,5,60,8.33333333333333
"5467","4/21/2013",120,5,115,4.34782608695652
"5468","4/21/2014",69,0,69,0
"5469","4/21/2015",67,1,66,1.51515151515152
"5470","4/21/2016",65,6,59,10.1694915254237
"5471","4/21/2017",68,2,66,3.03030303030303
"5472","4/21/2018",63,3,60,5
"5473","4/21/2019",127,4,123,3.2520325203252
"5474","4/21/2020",73,3,70,4.28571428571429
"5475","4/21/2021",68,1,67,1.49253731343284
"5476","4/22/1994",68,0,68,0
"5477","4/22/1995",65,1,64,1.5625
"5478","4/22/1996",75,0,75,0
"5479","4/22/1997",74,0,74,0
"5480","4/22/1998",70,2,68,2.94117647058824
"5481","4/22/1999",64,0,64,0
"5482","4/22/2000",65,2,63,3.17460317460317
"5483","4/22/2001",110,5,105,4.76190476190476
"5484","4/22/2002",73,1,72,1.38888888888889
"5485","4/22/2003",75,0,75,0
"5486","4/22/2004",66,1,65,1.53846153846154
"5487","4/22/2005",67,1,66,1.51515151515152
"5488","4/22/2006",59,4,55,7.27272727272727
"5489","4/22/2007",149,3,146,2.05479452054794
"5490","4/22/2008",72,1,71,1.40845070422535
"5491","4/22/2009",76,1,75,1.33333333333333
"5492","4/22/2010",71,1,70,1.42857142857143
"5493","4/22/2011",68,4,64,6.25
"5494","4/22/2012",125,4,121,3.30578512396694
"5495","4/22/2013",72,0,72,0
"5496","4/22/2014",73,0,73,0
"5497","4/22/2015",71,3,68,4.41176470588235
"5498","4/22/2016",62,5,57,8.7719298245614
"5499","4/22/2017",59,4,55,7.27272727272727
"5500","4/22/2018",127,4,123,3.2520325203252
"5501","4/22/2019",73,4,69,5.79710144927536
"5502","4/22/2020",73,6,67,8.95522388059701
"5503","4/22/2021",78,4,74,5.40540540540541
"5504","4/23/1994",61,3,58,5.17241379310345
"5505","4/23/1995",143,2,141,1.41843971631206
"5506","4/23/1996",75,0,75,0
"5507","4/23/1997",75,4,71,5.63380281690141
"5508","4/23/1998",71,2,69,2.89855072463768
"5509","4/23/1999",66,3,63,4.76190476190476
"5510","4/23/2000",129,0,129,0
"5511","4/23/2001",77,0,77,0
"5512","4/23/2002",75,5,70,7.14285714285714
"5513","4/23/2003",71,2,69,2.89855072463768
"5514","4/23/2004",64,2,62,3.2258064516129
"5515","4/23/2005",57,2,55,3.63636363636364
"5516","4/23/2006",123,4,119,3.36134453781513
"5517","4/23/2007",74,0,74,0
"5518","4/23/2008",74,4,70,5.71428571428571
"5519","4/23/2009",74,2,72,2.77777777777778
"5520","4/23/2010",66,4,62,6.45161290322581
"5521","4/23/2011",60,4,56,7.14285714285714
"5522","4/23/2012",70,1,69,1.44927536231884
"5523","4/23/2013",79,1,78,1.28205128205128
"5524","4/23/2014",73,2,71,2.8169014084507
"5525","4/23/2015",70,2,68,2.94117647058824
"5526","4/23/2016",63,0,63,0
"5527","4/23/2017",138,4,134,2.98507462686567
"5528","4/23/2018",76,0,76,0
"5529","4/23/2019",70,1,69,1.44927536231884
"5530","4/23/2020",68,4,64,6.25
"5531","4/23/2021",65,5,60,8.33333333333333
"5532","4/24/1994",129,2,127,1.5748031496063
"5533","4/24/1995",76,1,75,1.33333333333333
"5534","4/24/1996",70,2,68,2.94117647058824
"5535","4/24/1997",61,1,60,1.66666666666667
"5536","4/24/1998",60,8,52,15.3846153846154
"5537","4/24/1999",61,3,58,5.17241379310345
"5538","4/24/2000",76,0,76,0
"5539","4/24/2001",73,0,73,0
"5540","4/24/2002",75,1,74,1.35135135135135
"5541","4/24/2003",67,0,67,0
"5542","4/24/2004",65,1,64,1.5625
"5543","4/24/2005",133,1,132,0.757575757575758
"5544","4/24/2006",76,0,76,0
"5545","4/24/2007",72,0,72,0
"5546","4/24/2008",74,1,73,1.36986301369863
"5547","4/24/2009",65,5,60,8.33333333333333
"5548","4/24/2010",66,5,61,8.19672131147541
"5549","4/24/2011",130,12,118,10.1694915254237
"5550","4/24/2012",76,5,71,7.04225352112676
"5551","4/24/2013",65,2,63,3.17460317460317
"5552","4/24/2014",70,2,68,2.94117647058824
"5553","4/24/2015",51,4,47,8.51063829787234
"5554","4/24/2016",125,5,120,4.16666666666667
"5555","4/24/2017",76,1,75,1.33333333333333
"5556","4/24/2018",66,2,64,3.125
"5557","4/24/2019",72,3,69,4.34782608695652
"5558","4/24/2020",56,1,55,1.81818181818182
"5559","4/24/2021",61,8,53,15.0943396226415
"5560","4/25/1994",72,0,72,0
"5561","4/25/1995",74,0,74,0
"5562","4/25/1996",69,0,69,0
"5563","4/25/1997",67,1,66,1.51515151515152
"5564","4/25/1998",60,1,59,1.69491525423729
"5565","4/25/1999",121,2,119,1.68067226890756
"5566","4/25/2000",77,1,76,1.31578947368421
"5567","4/25/2001",74,2,72,2.77777777777778
"5568","4/25/2002",69,4,65,6.15384615384615
"5569","4/25/2003",63,1,62,1.61290322580645
"5570","4/25/2004",160,6,154,3.8961038961039
"5571","4/25/2005",73,0,73,0
"5572","4/25/2006",75,1,74,1.35135135135135
"5573","4/25/2007",71,1,70,1.42857142857143
"5574","4/25/2008",59,4,55,7.27272727272727
"5575","4/25/2009",63,1,62,1.61290322580645
"5576","4/25/2010",124,4,120,3.33333333333333
"5577","4/25/2011",72,1,71,1.40845070422535
"5578","4/25/2012",71,0,71,0
"5579","4/25/2013",63,4,59,6.77966101694915
"5580","4/25/2014",62,4,58,6.89655172413793
"5581","4/25/2015",65,4,61,6.55737704918033
"5582","4/25/2016",71,0,71,0
"5583","4/25/2017",76,1,75,1.33333333333333
"5584","4/25/2018",73,4,69,5.79710144927536
"5585","4/25/2019",72,3,69,4.34782608695652
"5586","4/25/2020",65,3,62,4.83870967741935
"5587","4/25/2021",122,7,115,6.08695652173913
"5588","4/26/1994",71,2,69,2.89855072463768
"5589","4/26/1995",73,1,72,1.38888888888889
"5590","4/26/1996",51,1,50,2
"5591","4/26/1997",56,2,54,3.7037037037037
"5592","4/26/1998",132,7,125,5.6
"5593","4/26/1999",73,0,73,0
"5594","4/26/2000",75,2,73,2.73972602739726
"5595","4/26/2001",66,7,59,11.864406779661
"5596","4/26/2002",54,2,52,3.84615384615385
"5597","4/26/2003",68,2,66,3.03030303030303
"5598","4/26/2004",72,0,72,0
"5599","4/26/2005",72,5,67,7.46268656716418
"5600","4/26/2006",74,0,74,0
"5601","4/26/2007",70,2,68,2.94117647058824
"5602","4/26/2008",64,1,63,1.58730158730159
"5603","4/26/2009",121,4,117,3.41880341880342
"5604","4/26/2010",73,0,73,0
"5605","4/26/2011",75,1,74,1.35135135135135
"5606","4/26/2012",63,4,59,6.77966101694915
"5607","4/26/2013",61,1,60,1.66666666666667
"5608","4/26/2014",61,5,56,8.92857142857143
"5609","4/26/2015",123,8,115,6.95652173913043
"5610","4/26/2016",72,7,65,10.7692307692308
"5611","4/26/2017",74,1,73,1.36986301369863
"5612","4/26/2018",71,3,68,4.41176470588235
"5613","4/26/2019",60,2,58,3.44827586206897
"5614","4/26/2020",119,6,113,5.30973451327434
"5615","4/26/2021",73,3,70,4.28571428571429
"5616","4/27/1994",70,2,68,2.94117647058824
"5617","4/27/1995",69,1,68,1.47058823529412
"5618","4/27/1996",67,0,67,0
"5619","4/27/1997",115,5,110,4.54545454545455
"5620","4/27/1998",77,0,77,0
"5621","4/27/1999",71,0,71,0
"5622","4/27/2000",72,0,72,0
"5623","4/27/2001",56,1,55,1.81818181818182
"5624","4/27/2002",65,5,60,8.33333333333333
"5625","4/27/2003",125,0,125,0
"5626","4/27/2004",71,1,70,1.42857142857143
"5627","4/27/2005",73,3,70,4.28571428571429
"5628","4/27/2006",69,3,66,4.54545454545455
"5629","4/27/2007",59,2,57,3.50877192982456
"5630","4/27/2008",130,4,126,3.17460317460317
"5631","4/27/2009",75,0,75,0
"5632","4/27/2010",74,0,74,0
"5633","4/27/2011",71,2,69,2.89855072463768
"5634","4/27/2012",58,4,54,7.40740740740741
"5635","4/27/2013",59,2,57,3.50877192982456
"5636","4/27/2014",131,5,126,3.96825396825397
"5637","4/27/2015",74,0,74,0
"5638","4/27/2016",72,0,72,0
"5639","4/27/2017",74,2,72,2.77777777777778
"5640","4/27/2018",64,2,62,3.2258064516129
"5641","4/27/2019",58,5,53,9.43396226415094
"5642","4/27/2020",72,0,72,0
"5643","4/27/2021",77,1,76,1.31578947368421
"5644","4/28/1994",75,3,72,4.16666666666667
"5645","4/28/1995",66,1,65,1.53846153846154
"5646","4/28/1996",128,2,126,1.58730158730159
"5647","4/28/1997",70,1,69,1.44927536231884
"5648","4/28/1998",67,1,66,1.51515151515152
"5649","4/28/1999",73,7,66,10.6060606060606
"5650","4/28/2000",66,7,59,11.864406779661
"5651","4/28/2001",59,4,55,7.27272727272727
"5652","4/28/2002",125,7,118,5.93220338983051
"5653","4/28/2003",73,2,71,2.8169014084507
"5654","4/28/2004",78,0,78,0
"5655","4/28/2005",69,3,66,4.54545454545455
"5656","4/28/2006",63,0,63,0
"5657","4/28/2007",57,4,53,7.54716981132075
"5658","4/28/2008",76,0,76,0
"5659","4/28/2009",76,2,74,2.7027027027027
"5660","4/28/2010",73,0,73,0
"5661","4/28/2011",67,2,65,3.07692307692308
"5662","4/28/2012",67,6,61,9.83606557377049
"5663","4/28/2013",125,4,121,3.30578512396694
"5664","4/28/2014",73,1,72,1.38888888888889
"5665","4/28/2015",74,3,71,4.22535211267606
"5666","4/28/2016",75,2,73,2.73972602739726
"5667","4/28/2017",63,3,60,5
"5668","4/28/2018",64,2,62,3.2258064516129
"5669","4/28/2019",127,6,121,4.95867768595041
"5670","4/28/2020",66,2,64,3.125
"5671","4/28/2021",73,2,71,2.8169014084507
"5672","4/29/1994",59,2,57,3.50877192982456
"5673","4/29/1995",65,4,61,6.55737704918033
"5674","4/29/1996",75,1,74,1.35135135135135
"5675","4/29/1997",73,0,73,0
"5676","4/29/1998",73,4,69,5.79710144927536
"5677","4/29/1999",67,1,66,1.51515151515152
"5678","4/29/2000",53,1,52,1.92307692307692
"5679","4/29/2001",150,5,145,3.44827586206897
"5680","4/29/2002",79,0,79,0
"5681","4/29/2003",71,1,70,1.42857142857143
"5682","4/29/2004",70,2,68,2.94117647058824
"5683","4/29/2005",67,3,64,4.6875
"5684","4/29/2006",53,4,49,8.16326530612245
"5685","4/29/2007",129,7,122,5.73770491803279
"5686","4/29/2008",71,0,71,0
"5687","4/29/2009",72,2,70,2.85714285714286
"5688","4/29/2010",65,0,65,0
"5689","4/29/2011",59,4,55,7.27272727272727
"5690","4/29/2012",133,3,130,2.30769230769231
"5691","4/29/2013",68,0,68,0
"5692","4/29/2014",73,3,70,4.28571428571429
"5693","4/29/2015",72,2,70,2.85714285714286
"5694","4/29/2016",60,5,55,9.09090909090909
"5695","4/29/2017",61,6,55,10.9090909090909
"5696","4/29/2018",130,5,125,4
"5697","4/29/2019",74,1,73,1.36986301369863
"5698","4/29/2020",73,2,71,2.8169014084507
"5699","4/29/2021",67,3,64,4.6875
"5700","4/3/1994",117,2,115,1.73913043478261
"5701","4/3/1995",74,0,74,0
"5702","4/3/1996",68,0,68,0
"5703","4/3/1997",73,3,70,4.28571428571429
"5704","4/3/1998",53,1,52,1.92307692307692
"5705","4/3/1999",69,2,67,2.98507462686567
"5706","4/3/2000",76,0,76,0
"5707","4/3/2001",68,1,67,1.49253731343284
"5708","4/3/2002",71,0,71,0
"5709","4/3/2003",69,4,65,6.15384615384615
"5710","4/3/2004",64,1,63,1.58730158730159
"5711","4/3/2005",137,0,137,0
"5712","4/3/2006",74,0,74,0
"5713","4/3/2007",69,0,69,0
"5714","4/3/2008",71,1,70,1.42857142857143
"5715","4/3/2009",62,7,55,12.7272727272727
"5716","4/3/2010",64,4,60,6.66666666666667
"5717","4/3/2011",125,2,123,1.6260162601626
"5718","4/3/2012",66,2,64,3.125
"5719","4/3/2013",73,3,70,4.28571428571429
"5720","4/3/2014",66,1,65,1.53846153846154
"5721","4/3/2015",63,7,56,12.5
"5722","4/3/2016",126,4,122,3.27868852459016
"5723","4/3/2017",73,3,70,4.28571428571429
"5724","4/3/2018",83,1,82,1.21951219512195
"5725","4/3/2019",70,0,70,0
"5726","4/3/2020",66,1,65,1.53846153846154
"5727","4/3/2021",59,3,56,5.35714285714286
"5728","4/30/1994",66,1,65,1.53846153846154
"5729","4/30/1995",130,0,130,0
"5730","4/30/1996",77,0,77,0
"5731","4/30/1997",71,1,70,1.42857142857143
"5732","4/30/1998",72,1,71,1.40845070422535
"5733","4/30/1999",60,8,52,15.3846153846154
"5734","4/30/2000",124,5,119,4.20168067226891
"5735","4/30/2001",68,0,68,0
"5736","4/30/2002",75,3,72,4.16666666666667
"5737","4/30/2003",73,2,71,2.8169014084507
"5738","4/30/2004",60,2,58,3.44827586206897
"5739","4/30/2005",64,2,62,3.2258064516129
"5740","4/30/2006",126,3,123,2.4390243902439
"5741","4/30/2007",73,0,73,0
"5742","4/30/2008",61,2,59,3.38983050847458
"5743","4/30/2009",74,7,67,10.4477611940298
"5744","4/30/2010",65,5,60,8.33333333333333
"5745","4/30/2011",71,7,64,10.9375
"5746","4/30/2012",71,2,69,2.89855072463768
"5747","4/30/2013",71,1,70,1.42857142857143
"5748","4/30/2014",74,2,72,2.77777777777778
"5749","4/30/2015",65,4,61,6.55737704918033
"5750","4/30/2016",53,5,48,10.4166666666667
"5751","4/30/2017",129,9,120,7.5
"5752","4/30/2018",70,4,66,6.06060606060606
"5753","4/30/2019",72,1,71,1.40845070422535
"5754","4/30/2020",71,2,69,2.89855072463768
"5755","4/30/2021",64,4,60,6.66666666666667
"5756","4/4/1994",74,0,74,0
"5757","4/4/1995",72,1,71,1.40845070422535
"5758","4/4/1996",68,3,65,4.61538461538462
"5759","4/4/1997",59,1,58,1.72413793103448
"5760","4/4/1998",63,1,62,1.61290322580645
"5761","4/4/1999",127,3,124,2.41935483870968
"5762","4/4/2000",68,0,68,0
"5763","4/4/2001",73,5,68,7.35294117647059
"5764","4/4/2002",66,0,66,0
"5765","4/4/2003",66,6,60,10
"5766","4/4/2004",123,6,117,5.12820512820513
"5767","4/4/2005",77,3,74,4.05405405405405
"5768","4/4/2006",74,0,74,0
"5769","4/4/2007",76,1,75,1.33333333333333
"5770","4/4/2008",67,6,61,9.83606557377049
"5771","4/4/2009",64,1,63,1.58730158730159
"5772","4/4/2010",128,8,120,6.66666666666667
"5773","4/4/2011",74,1,73,1.36986301369863
"5774","4/4/2012",67,0,67,0
"5775","4/4/2013",67,3,64,4.6875
"5776","4/4/2014",57,7,50,14
"5777","4/4/2015",66,3,63,4.76190476190476
"5778","4/4/2016",75,2,73,2.73972602739726
"5779","4/4/2017",74,2,72,2.77777777777778
"5780","4/4/2018",71,2,69,2.89855072463768
"5781","4/4/2019",70,2,68,2.94117647058824
"5782","4/4/2020",64,2,62,3.2258064516129
"5783","4/4/2021",129,3,126,2.38095238095238
"5784","4/5/1994",69,2,67,2.98507462686567
"5785","4/5/1995",73,0,73,0
"5786","4/5/1996",54,4,50,8
"5787","4/5/1997",60,1,59,1.69491525423729
"5788","4/5/1998",118,5,113,4.42477876106195
"5789","4/5/1999",76,0,76,0
"5790","4/5/2000",75,0,75,0
"5791","4/5/2001",69,1,68,1.47058823529412
"5792","4/5/2002",68,2,66,3.03030303030303
"5793","4/5/2003",60,4,56,7.14285714285714
"5794","4/5/2004",72,0,72,0
"5795","4/5/2005",76,2,74,2.7027027027027
"5796","4/5/2006",71,0,71,0
"5797","4/5/2007",74,1,73,1.36986301369863
"5798","4/5/2008",66,3,63,4.76190476190476
"5799","4/5/2009",157,6,151,3.97350993377483
"5800","4/5/2010",74,0,74,0
"5801","4/5/2011",71,2,69,2.89855072463768
"5802","4/5/2012",63,2,61,3.27868852459016
"5803","4/5/2013",59,0,59,0
"5804","4/5/2014",61,5,56,8.92857142857143
"5805","4/5/2015",127,10,117,8.54700854700855
"5806","4/5/2016",70,3,67,4.47761194029851
"5807","4/5/2017",62,1,61,1.63934426229508
"5808","4/5/2018",73,9,64,14.0625
"5809","4/5/2019",55,3,52,5.76923076923077
"5810","4/5/2020",131,4,127,3.1496062992126
"5811","4/5/2021",73,1,72,1.38888888888889
"5812","4/6/1994",76,0,76,0
"5813","4/6/1995",68,1,67,1.49253731343284
"5814","4/6/1996",65,0,65,0
"5815","4/6/1997",123,2,121,1.65289256198347
"5816","4/6/1998",75,3,72,4.16666666666667
"5817","4/6/1999",72,0,72,0
"5818","4/6/2000",69,4,65,6.15384615384615
"5819","4/6/2001",63,2,61,3.27868852459016
"5820","4/6/2002",62,5,57,8.7719298245614
"5821","4/6/2003",125,6,119,5.04201680672269
"5822","4/6/2004",69,0,69,0
"5823","4/6/2005",75,2,73,2.73972602739726
"5824","4/6/2006",61,1,60,1.66666666666667
"5825","4/6/2007",67,3,64,4.6875
"5826","4/6/2008",124,2,122,1.63934426229508
"5827","4/6/2009",75,0,75,0
"5828","4/6/2010",76,1,75,1.33333333333333
"5829","4/6/2011",72,1,71,1.40845070422535
"5830","4/6/2012",63,5,58,8.62068965517241
"5831","4/6/2013",59,4,55,7.27272727272727
"5832","4/6/2014",129,10,119,8.40336134453782
"5833","4/6/2015",75,2,73,2.73972602739726
"5834","4/6/2016",71,4,67,5.97014925373134
"5835","4/6/2017",75,3,72,4.16666666666667
"5836","4/6/2018",64,1,63,1.58730158730159
"5837","4/6/2019",61,4,57,7.01754385964912
"5838","4/6/2020",74,0,74,0
"5839","4/6/2021",69,3,66,4.54545454545455
"5840","4/7/1994",61,1,60,1.66666666666667
"5841","4/7/1995",58,0,58,0
"5842","4/7/1996",127,0,127,0
"5843","4/7/1997",73,0,73,0
"5844","4/7/1998",73,0,73,0
"5845","4/7/1999",73,2,71,2.8169014084507
"5846","4/7/2000",68,5,63,7.93650793650794
"5847","4/7/2001",55,2,53,3.77358490566038
"5848","4/7/2002",132,8,124,6.45161290322581
"5849","4/7/2003",74,0,74,0
"5850","4/7/2004",72,4,68,5.88235294117647
"5851","4/7/2005",72,2,70,2.85714285714286
"5852","4/7/2006",66,0,66,0
"5853","4/7/2007",63,3,60,5
"5854","4/7/2008",75,5,70,7.14285714285714
"5855","4/7/2009",72,1,71,1.40845070422535
"5856","4/7/2010",74,2,72,2.77777777777778
"5857","4/7/2011",62,5,57,8.7719298245614
"5858","4/7/2012",60,6,54,11.1111111111111
"5859","4/7/2013",123,4,119,3.36134453781513
"5860","4/7/2014",78,0,78,0
"5861","4/7/2015",66,0,66,0
"5862","4/7/2016",70,4,66,6.06060606060606
"5863","4/7/2017",54,1,53,1.88679245283019
"5864","4/7/2018",56,1,55,1.81818181818182
"5865","4/7/2019",127,6,121,4.95867768595041
"5866","4/7/2020",72,1,71,1.40845070422535
"5867","4/7/2021",67,2,65,3.07692307692308
"5868","4/8/1994",69,3,66,4.54545454545455
"5869","4/8/1995",61,1,60,1.66666666666667
"5870","4/8/1996",72,0,72,0
"5871","4/8/1997",73,2,71,2.8169014084507
"5872","4/8/1998",75,1,74,1.35135135135135
"5873","4/8/1999",68,3,65,4.61538461538462
"5874","4/8/2000",62,4,58,6.89655172413793
"5875","4/8/2001",127,3,124,2.41935483870968
"5876","4/8/2002",68,1,67,1.49253731343284
"5877","4/8/2003",70,0,70,0
"5878","4/8/2004",66,3,63,4.76190476190476
"5879","4/8/2005",61,1,60,1.66666666666667
"5880","4/8/2006",58,4,54,7.40740740740741
"5881","4/8/2007",133,11,122,9.01639344262295
"5882","4/8/2008",72,0,72,0
"5883","4/8/2009",73,0,73,0
"5884","4/8/2010",70,6,64,9.375
"5885","4/8/2011",57,2,55,3.63636363636364
"5886","4/8/2012",128,8,120,6.66666666666667
"5887","4/8/2013",76,0,76,0
"5888","4/8/2014",73,1,72,1.38888888888889
"5889","4/8/2015",74,1,73,1.36986301369863
"5890","4/8/2016",62,8,54,14.8148148148148
"5891","4/8/2017",51,4,47,8.51063829787234
"5892","4/8/2018",122,5,117,4.27350427350427
"5893","4/8/2019",75,0,75,0
"5894","4/8/2020",72,3,69,4.34782608695652
"5895","4/8/2021",70,4,66,6.06060606060606
"5896","4/9/1994",57,1,56,1.78571428571429
"5897","4/9/1995",127,3,124,2.41935483870968
"5898","4/9/1996",76,0,76,0
"5899","4/9/1997",74,1,73,1.36986301369863
"5900","4/9/1998",68,1,67,1.49253731343284
"5901","4/9/1999",65,3,62,4.83870967741935
"5902","4/9/2000",125,7,118,5.93220338983051
"5903","4/9/2001",71,1,70,1.42857142857143
"5904","4/9/2002",74,1,73,1.36986301369863
"5905","4/9/2003",74,4,70,5.71428571428571
"5906","4/9/2004",61,5,56,8.92857142857143
"5907","4/9/2005",59,0,59,0
"5908","4/9/2006",152,1,151,0.662251655629139
"5909","4/9/2007",75,0,75,0
"5910","4/9/2008",74,3,71,4.22535211267606
"5911","4/9/2009",69,4,65,6.15384615384615
"5912","4/9/2010",65,5,60,8.33333333333333
"5913","4/9/2011",64,4,60,6.66666666666667
"5914","4/9/2012",74,0,74,0
"5915","4/9/2013",73,2,71,2.8169014084507
"5916","4/9/2014",74,2,72,2.77777777777778
"5917","4/9/2015",71,6,65,9.23076923076923
"5918","4/9/2016",62,5,57,8.7719298245614
"5919","4/9/2017",112,3,109,2.75229357798165
"5920","4/9/2018",67,1,66,1.51515151515152
"5921","4/9/2019",74,2,72,2.77777777777778
"5922","4/9/2020",65,3,62,4.83870967741935
"5923","4/9/2021",64,5,59,8.47457627118644
"5924","5/1/1994",127,4,123,3.2520325203252
"5925","5/1/1995",74,0,74,0
"5926","5/1/1996",67,1,66,1.51515151515152
"5927","5/1/1997",67,1,66,1.51515151515152
"5928","5/1/1998",63,2,61,3.27868852459016
"5929","5/1/1999",68,1,67,1.49253731343284
"5930","5/1/2000",74,1,73,1.36986301369863
"5931","5/1/2001",72,0,72,0
"5932","5/1/2002",68,3,65,4.61538461538462
"5933","5/1/2003",63,3,60,5
"5934","5/1/2004",56,5,51,9.80392156862745
"5935","5/1/2005",120,1,119,0.840336134453782
"5936","5/1/2006",73,0,73,0
"5937","5/1/2007",71,1,70,1.42857142857143
"5938","5/1/2008",68,2,66,3.03030303030303
"5939","5/1/2009",67,6,61,9.83606557377049
"5940","5/1/2010",60,4,56,7.14285714285714
"5941","5/1/2011",129,6,123,4.8780487804878
"5942","5/1/2012",69,1,68,1.47058823529412
"5943","5/1/2013",72,3,69,4.34782608695652
"5944","5/1/2014",73,4,69,5.79710144927536
"5945","5/1/2015",65,5,60,8.33333333333333
"5946","5/1/2016",111,2,109,1.8348623853211
"5947","5/1/2017",68,1,67,1.49253731343284
"5948","5/1/2018",75,2,73,2.73972602739726
"5949","5/1/2019",66,1,65,1.53846153846154
"5950","5/1/2020",66,2,64,3.125
"5951","5/1/2021",60,7,53,13.2075471698113
"5952","5/10/1994",69,2,67,2.98507462686567
"5953","5/10/1995",71,2,69,2.89855072463768
"5954","5/10/1996",66,0,66,0
"5955","5/10/1997",72,2,70,2.85714285714286
"5956","5/10/1998",130,5,125,4
"5957","5/10/1999",72,0,72,0
"5958","5/10/2000",71,1,70,1.42857142857143
"5959","5/10/2001",67,5,62,8.06451612903226
"5960","5/10/2002",63,1,62,1.61290322580645
"5961","5/10/2003",56,4,52,7.69230769230769
"5962","5/10/2004",72,0,72,0
"5963","5/10/2005",74,1,73,1.36986301369863
"5964","5/10/2006",76,1,75,1.33333333333333
"5965","5/10/2007",67,2,65,3.07692307692308
"5966","5/10/2008",64,3,61,4.91803278688525
"5967","5/10/2009",122,6,116,5.17241379310345
"5968","5/10/2010",74,1,73,1.36986301369863
"5969","5/10/2011",75,2,73,2.73972602739726
"5970","5/10/2012",70,5,65,7.69230769230769
"5971","5/10/2013",65,4,61,6.55737704918033
"5972","5/10/2014",69,3,66,4.54545454545455
"5973","5/10/2015",125,7,118,5.93220338983051
"5974","5/10/2016",74,2,72,2.77777777777778
"5975","5/10/2017",75,0,75,0
"5976","5/10/2018",63,3,60,5
"5977","5/10/2019",61,4,57,7.01754385964912
"5978","5/10/2020",120,5,115,4.34782608695652
"5979","5/10/2021",75,1,74,1.35135135135135
"5980","5/11/1994",72,2,70,2.85714285714286
"5981","5/11/1995",69,0,69,0
"5982","5/11/1996",65,2,63,3.17460317460317
"5983","5/11/1997",130,2,128,1.5625
"5984","5/11/1998",76,2,74,2.7027027027027
"5985","5/11/1999",75,0,75,0
"5986","5/11/2000",64,1,63,1.58730158730159
"5987","5/11/2001",63,5,58,8.62068965517241
"5988","5/11/2002",57,3,54,5.55555555555556
"5989","5/11/2003",124,7,117,5.98290598290598
"5990","5/11/2004",73,2,71,2.8169014084507
"5991","5/11/2005",72,3,69,4.34782608695652
"5992","5/11/2006",64,2,62,3.2258064516129
"5993","5/11/2007",59,3,56,5.35714285714286
"5994","5/11/2008",130,5,125,4
"5995","5/11/2009",77,0,77,0
"5996","5/11/2010",74,4,70,5.71428571428571
"5997","5/11/2011",72,1,71,1.40845070422535
"5998","5/11/2012",65,1,64,1.5625
"5999","5/11/2013",66,3,63,4.76190476190476
"6000","5/11/2014",119,5,114,4.3859649122807
"6001","5/11/2015",72,0,72,0
"6002","5/11/2016",67,2,65,3.07692307692308
"6003","5/11/2017",70,8,62,12.9032258064516
"6004","5/11/2018",61,6,55,10.9090909090909
"6005","5/11/2019",67,5,62,8.06451612903226
"6006","5/11/2020",73,1,72,1.38888888888889
"6007","5/11/2021",70,2,68,2.94117647058824
"6008","5/12/1994",61,0,61,0
"6009","5/12/1995",62,0,62,0
"6010","5/12/1996",130,4,126,3.17460317460317
"6011","5/12/1997",74,0,74,0
"6012","5/12/1998",76,1,75,1.33333333333333
"6013","5/12/1999",73,5,68,7.35294117647059
"6014","5/12/2000",61,1,60,1.66666666666667
"6015","5/12/2001",65,4,61,6.55737704918033
"6016","5/12/2002",127,1,126,0.793650793650794
"6017","5/12/2003",72,0,72,0
"6018","5/12/2004",73,0,73,0
"6019","5/12/2005",65,1,64,1.5625
"6020","5/12/2006",66,1,65,1.53846153846154
"6021","5/12/2007",64,1,63,1.58730158730159
"6022","5/12/2008",74,3,71,4.22535211267606
"6023","5/12/2009",74,0,74,0
"6024","5/12/2010",77,6,71,8.45070422535211
"6025","5/12/2011",71,3,68,4.41176470588235
"6026","5/12/2012",60,3,57,5.26315789473684
"6027","5/12/2013",125,4,121,3.30578512396694
"6028","5/12/2014",78,0,78,0
"6029","5/12/2015",71,2,69,2.89855072463768
"6030","5/12/2016",70,3,67,4.47761194029851
"6031","5/12/2017",68,5,63,7.93650793650794
"6032","5/12/2018",62,5,57,8.7719298245614
"6033","5/12/2019",123,2,121,1.65289256198347
"6034","5/12/2020",71,2,69,2.89855072463768
"6035","5/12/2021",71,6,65,9.23076923076923
"6036","5/13/1994",45,0,45,0
"6037","5/13/1995",63,1,62,1.61290322580645
"6038","5/13/1996",74,0,74,0
"6039","5/13/1997",75,3,72,4.16666666666667
"6040","5/13/1998",76,2,74,2.7027027027027
"6041","5/13/1999",70,3,67,4.47761194029851
"6042","5/13/2000",67,4,63,6.34920634920635
"6043","5/13/2001",124,5,119,4.20168067226891
"6044","5/13/2002",73,1,72,1.38888888888889
"6045","5/13/2003",73,0,73,0
"6046","5/13/2004",69,2,67,2.98507462686567
"6047","5/13/2005",67,3,64,4.6875
"6048","5/13/2006",54,3,51,5.88235294117647
"6049","5/13/2007",125,5,120,4.16666666666667
"6050","5/13/2008",76,0,76,0
"6051","5/13/2009",75,1,74,1.35135135135135
"6052","5/13/2010",66,2,64,3.125
"6053","5/13/2011",53,2,51,3.92156862745098
"6054","5/13/2012",127,7,120,5.83333333333333
"6055","5/13/2013",72,0,72,0
"6056","5/13/2014",73,2,71,2.8169014084507
"6057","5/13/2015",75,1,74,1.35135135135135
"6058","5/13/2016",63,5,58,8.62068965517241
"6059","5/13/2017",59,2,57,3.50877192982456
"6060","5/13/2018",130,9,121,7.43801652892562
"6061","5/13/2019",74,1,73,1.36986301369863
"6062","5/13/2020",65,4,61,6.55737704918033
"6063","5/13/2021",74,1,73,1.36986301369863
"6064","5/14/1994",58,0,58,0
"6065","5/14/1995",124,4,120,3.33333333333333
"6066","5/14/1996",75,0,75,0
"6067","5/14/1997",74,1,73,1.36986301369863
"6068","5/14/1998",70,2,68,2.94117647058824
"6069","5/14/1999",51,1,50,2
"6070","5/14/2000",130,3,127,2.36220472440945
"6071","5/14/2001",77,1,76,1.31578947368421
"6072","5/14/2002",73,1,72,1.38888888888889
"6073","5/14/2003",75,3,72,4.16666666666667
"6074","5/14/2004",63,0,63,0
"6075","5/14/2005",61,0,61,0
"6076","5/14/2006",130,3,127,2.36220472440945
"6077","5/14/2007",77,3,74,4.05405405405405
"6078","5/14/2008",69,3,66,4.54545454545455
"6079","5/14/2009",64,5,59,8.47457627118644
"6080","5/14/2010",59,6,53,11.3207547169811
"6081","5/14/2011",67,8,59,13.5593220338983
"6082","5/14/2012",70,0,70,0
"6083","5/14/2013",76,1,75,1.33333333333333
"6084","5/14/2014",75,0,75,0
"6085","5/14/2015",71,2,69,2.89855072463768
"6086","5/14/2016",52,6,46,13.0434782608696
"6087","5/14/2017",121,3,118,2.54237288135593
"6088","5/14/2018",74,0,74,0
"6089","5/14/2019",75,4,71,5.63380281690141
"6090","5/14/2020",73,4,69,5.79710144927536
"6091","5/14/2021",65,5,60,8.33333333333333
"6092","5/15/1994",124,2,122,1.63934426229508
"6093","5/15/1995",76,1,75,1.33333333333333
"6094","5/15/1996",73,0,73,0
"6095","5/15/1997",71,3,68,4.41176470588235
"6096","5/15/1998",64,5,59,8.47457627118644
"6097","5/15/1999",63,6,57,10.5263157894737
"6098","5/15/2000",74,0,74,0
"6099","5/15/2001",71,0,71,0
"6100","5/15/2002",69,1,68,1.47058823529412
"6101","5/15/2003",70,4,66,6.06060606060606
"6102","5/15/2004",54,2,52,3.84615384615385
"6103","5/15/2005",118,4,114,3.50877192982456
"6104","5/15/2006",77,0,77,0
"6105","5/15/2007",74,1,73,1.36986301369863
"6106","5/15/2008",67,1,66,1.51515151515152
"6107","5/15/2009",64,6,58,10.3448275862069
"6108","5/15/2010",61,1,60,1.66666666666667
"6109","5/15/2011",128,1,127,0.78740157480315
"6110","5/15/2012",75,2,73,2.73972602739726
"6111","5/15/2013",70,0,70,0
"6112","5/15/2014",72,2,70,2.85714285714286
"6113","5/15/2015",61,6,55,10.9090909090909
"6114","5/15/2016",130,10,120,8.33333333333333
"6115","5/15/2017",75,2,73,2.73972602739726
"6116","5/15/2018",66,1,65,1.53846153846154
"6117","5/15/2019",67,1,66,1.51515151515152
"6118","5/15/2020",57,1,56,1.78571428571429
"6119","5/15/2021",58,5,53,9.43396226415094
"6120","5/16/1994",75,0,75,0
"6121","5/16/1995",72,0,72,0
"6122","5/16/1996",68,3,65,4.61538461538462
"6123","5/16/1997",63,0,63,0
"6124","5/16/1998",62,2,60,3.33333333333333
"6125","5/16/1999",181,3,178,1.68539325842697
"6126","5/16/2000",74,2,72,2.77777777777778
"6127","5/16/2001",76,4,72,5.55555555555556
"6128","5/16/2002",62,2,60,3.33333333333333
"6129","5/16/2003",69,2,67,2.98507462686567
"6130","5/16/2004",124,4,120,3.33333333333333
"6131","5/16/2005",73,0,73,0
"6132","5/16/2006",72,1,71,1.40845070422535
"6133","5/16/2007",74,2,72,2.77777777777778
"6134","5/16/2008",66,4,62,6.45161290322581
"6135","5/16/2009",58,5,53,9.43396226415094
"6136","5/16/2010",106,4,102,3.92156862745098
"6137","5/16/2011",77,0,77,0
"6138","5/16/2012",63,1,62,1.61290322580645
"6139","5/16/2013",67,2,65,3.07692307692308
"6140","5/16/2014",65,8,57,14.0350877192982
"6141","5/16/2015",50,3,47,6.38297872340426
"6142","5/16/2016",74,0,74,0
"6143","5/16/2017",64,3,61,4.91803278688525
"6144","5/16/2018",73,3,70,4.28571428571429
"6145","5/16/2019",63,3,60,5
"6146","5/16/2020",63,3,60,5
"6147","5/16/2021",128,9,119,7.56302521008403
"6148","5/17/1994",68,2,66,3.03030303030303
"6149","5/17/1995",68,0,68,0
"6150","5/17/1996",63,2,61,3.27868852459016
"6151","5/17/1997",65,2,63,3.17460317460317
"6152","5/17/1998",148,4,144,2.77777777777778
"6153","5/17/1999",75,2,73,2.73972602739726
"6154","5/17/2000",75,3,72,4.16666666666667
"6155","5/17/2001",61,3,58,5.17241379310345
"6156","5/17/2002",62,1,61,1.63934426229508
"6157","5/17/2003",61,4,57,7.01754385964912
"6158","5/17/2004",69,0,69,0
"6159","5/17/2005",75,2,73,2.73972602739726
"6160","5/17/2006",70,3,67,4.47761194029851
"6161","5/17/2007",73,1,72,1.38888888888889
"6162","5/17/2008",59,8,51,15.6862745098039
"6163","5/17/2009",123,1,122,0.819672131147541
"6164","5/17/2010",73,0,73,0
"6165","5/17/2011",72,0,72,0
"6166","5/17/2012",54,2,52,3.84615384615385
"6167","5/17/2013",61,4,57,7.01754385964912
"6168","5/17/2014",60,3,57,5.26315789473684
"6169","5/17/2015",128,8,120,6.66666666666667
"6170","5/17/2016",74,3,71,4.22535211267606
"6171","5/17/2017",66,0,66,0
"6172","5/17/2018",70,4,66,6.06060606060606
"6173","5/17/2019",57,4,53,7.54716981132075
"6174","5/17/2020",94,4,90,4.44444444444444
"6175","5/17/2021",76,0,76,0
"6176","5/18/1994",62,0,62,0
"6177","5/18/1995",64,0,64,0
"6178","5/18/1996",61,1,60,1.66666666666667
"6179","5/18/1997",129,1,128,0.78125
"6180","5/18/1998",71,0,71,0
"6181","5/18/1999",69,0,69,0
"6182","5/18/2000",63,8,55,14.5454545454545
"6183","5/18/2001",64,4,60,6.66666666666667
"6184","5/18/2002",58,3,55,5.45454545454545
"6185","5/18/2003",127,1,126,0.793650793650794
"6186","5/18/2004",72,1,71,1.40845070422535
"6187","5/18/2005",75,3,72,4.16666666666667
"6188","5/18/2006",71,1,70,1.42857142857143
"6189","5/18/2007",63,3,60,5
"6190","5/18/2008",126,3,123,2.4390243902439
"6191","5/18/2009",72,0,72,0
"6192","5/18/2010",71,0,71,0
"6193","5/18/2011",74,3,71,4.22535211267606
"6194","5/18/2012",67,5,62,8.06451612903226
"6195","5/18/2013",61,5,56,8.92857142857143
"6196","5/18/2014",119,7,112,6.25
"6197","5/18/2015",74,0,74,0
"6198","5/18/2016",68,1,67,1.49253731343284
"6199","5/18/2017",74,3,71,4.22535211267606
"6200","5/18/2018",52,3,49,6.12244897959184
"6201","5/18/2019",59,0,59,0
"6202","5/18/2020",75,2,73,2.73972602739726
"6203","5/18/2021",72,1,71,1.40845070422535
"6204","5/19/1994",71,3,68,4.41176470588235
"6205","5/19/1995",71,2,69,2.89855072463768
"6206","5/19/1996",128,2,126,1.58730158730159
"6207","5/19/1997",76,0,76,0
"6208","5/19/1998",77,2,75,2.66666666666667
"6209","5/19/1999",72,3,69,4.34782608695652
"6210","5/19/2000",66,2,64,3.125
"6211","5/19/2001",70,0,70,0
"6212","5/19/2002",129,7,122,5.73770491803279
"6213","5/19/2003",71,0,71,0
"6214","5/19/2004",71,2,69,2.89855072463768
"6215","5/19/2005",69,2,67,2.98507462686567
"6216","5/19/2006",57,2,55,3.63636363636364
"6217","5/19/2007",54,3,51,5.88235294117647
"6218","5/19/2008",67,0,67,0
"6219","5/19/2009",75,0,75,0
"6220","5/19/2010",72,0,72,0
"6221","5/19/2011",69,3,66,4.54545454545455
"6222","5/19/2012",62,4,58,6.89655172413793
"6223","5/19/2013",129,3,126,2.38095238095238
"6224","5/19/2014",73,2,71,2.8169014084507
"6225","5/19/2015",75,2,73,2.73972602739726
"6226","5/19/2016",64,3,61,4.91803278688525
"6227","5/19/2017",60,2,58,3.44827586206897
"6228","5/19/2018",60,5,55,9.09090909090909
"6229","5/19/2019",122,4,118,3.38983050847458
"6230","5/19/2020",72,2,70,2.85714285714286
"6231","5/19/2021",72,2,70,2.85714285714286
"6232","5/2/1994",73,0,73,0
"6233","5/2/1995",63,0,63,0
"6234","5/2/1996",62,1,61,1.63934426229508
"6235","5/2/1997",66,2,64,3.125
"6236","5/2/1998",68,1,67,1.49253731343284
"6237","5/2/1999",116,5,111,4.5045045045045
"6238","5/2/2000",68,1,67,1.49253731343284
"6239","5/2/2001",72,6,66,9.09090909090909
"6240","5/2/2002",68,2,66,3.03030303030303
"6241","5/2/2003",66,1,65,1.53846153846154
"6242","5/2/2004",115,2,113,1.76991150442478
"6243","5/2/2005",72,0,72,0
"6244","5/2/2006",74,0,74,0
"6245","5/2/2007",73,3,70,4.28571428571429
"6246","5/2/2008",63,3,60,5
"6247","5/2/2009",69,2,67,2.98507462686567
"6248","5/2/2010",126,4,122,3.27868852459016
"6249","5/2/2011",72,0,72,0
"6250","5/2/2012",65,2,63,3.17460317460317
"6251","5/2/2013",70,1,69,1.44927536231884
"6252","5/2/2014",59,1,58,1.72413793103448
"6253","5/2/2015",62,5,57,8.7719298245614
"6254","5/2/2016",75,0,75,0
"6255","5/2/2017",72,3,69,4.34782608695652
"6256","5/2/2018",74,2,72,2.77777777777778
"6257","5/2/2019",71,4,67,5.97014925373134
"6258","5/2/2020",58,0,58,0
"6259","5/2/2021",129,12,117,10.2564102564103
"6260","5/20/1994",69,1,68,1.47058823529412
"6261","5/20/1995",56,0,56,0
"6262","5/20/1996",75,0,75,0
"6263","5/20/1997",73,1,72,1.38888888888889
"6264","5/20/1998",68,1,67,1.49253731343284
"6265","5/20/1999",70,3,67,4.47761194029851
"6266","5/20/2000",62,3,59,5.08474576271187
"6267","5/20/2001",124,1,123,0.813008130081301
"6268","5/20/2002",71,0,71,0
"6269","5/20/2003",73,2,71,2.8169014084507
"6270","5/20/2004",72,0,72,0
"6271","5/20/2005",70,2,68,2.94117647058824
"6272","5/20/2006",64,2,62,3.2258064516129
"6273","5/20/2007",149,5,144,3.47222222222222
"6274","5/20/2008",71,3,68,4.41176470588235
"6275","5/20/2009",65,1,64,1.5625
"6276","5/20/2010",72,3,69,4.34782608695652
"6277","5/20/2011",59,4,55,7.27272727272727
"6278","5/20/2012",125,7,118,5.93220338983051
"6279","5/20/2013",70,0,70,0
"6280","5/20/2014",70,2,68,2.94117647058824
"6281","5/20/2015",74,0,74,0
"6282","5/20/2016",67,3,64,4.6875
"6283","5/20/2017",57,7,50,14
"6284","5/20/2018",123,4,119,3.36134453781513
"6285","5/20/2019",69,1,68,1.47058823529412
"6286","5/20/2020",75,3,72,4.16666666666667
"6287","5/20/2021",69,2,67,2.98507462686567
"6288","5/21/1994",60,0,60,0
"6289","5/21/1995",129,0,129,0
"6290","5/21/1996",76,1,75,1.33333333333333
"6291","5/21/1997",73,1,72,1.38888888888889
"6292","5/21/1998",71,2,69,2.89855072463768
"6293","5/21/1999",61,6,55,10.9090909090909
"6294","5/21/2000",128,7,121,5.78512396694215
"6295","5/21/2001",78,0,78,0
"6296","5/21/2002",72,2,70,2.85714285714286
"6297","5/21/2003",72,3,69,4.34782608695652
"6298","5/21/2004",62,1,61,1.63934426229508
"6299","5/21/2005",65,1,64,1.5625
"6300","5/21/2006",131,4,127,3.1496062992126
"6301","5/21/2007",76,0,76,0
"6302","5/21/2008",73,4,69,5.79710144927536
"6303","5/21/2009",72,4,68,5.88235294117647
"6304","5/21/2010",59,4,55,7.27272727272727
"6305","5/21/2011",63,3,60,5
"6306","5/21/2012",72,0,72,0
"6307","5/21/2013",70,2,68,2.94117647058824
"6308","5/21/2014",66,2,64,3.125
"6309","5/21/2015",71,2,69,2.89855072463768
"6310","5/21/2016",63,0,63,0
"6311","5/21/2017",118,8,110,7.27272727272727
"6312","5/21/2018",72,0,72,0
"6313","5/21/2019",74,3,71,4.22535211267606
"6314","5/21/2020",77,2,75,2.66666666666667
"6315","5/21/2021",58,5,53,9.43396226415094
"6316","5/22/1994",148,1,147,0.680272108843537
"6317","5/22/1995",77,0,77,0
"6318","5/22/1996",70,1,69,1.44927536231884
"6319","5/22/1997",63,3,60,5
"6320","5/22/1998",65,4,61,6.55737704918033
"6321","5/22/1999",62,1,61,1.63934426229508
"6322","5/22/2000",76,0,76,0
"6323","5/22/2001",72,1,71,1.40845070422535
"6324","5/22/2002",70,5,65,7.69230769230769
"6325","5/22/2003",75,4,71,5.63380281690141
"6326","5/22/2004",59,1,58,1.72413793103448
"6327","5/22/2005",159,1,158,0.632911392405063
"6328","5/22/2006",72,0,72,0
"6329","5/22/2007",71,4,67,5.97014925373134
"6330","5/22/2008",67,6,61,9.83606557377049
"6331","5/22/2009",60,3,57,5.26315789473684
"6332","5/22/2010",55,5,50,10
"6333","5/22/2011",132,9,123,7.31707317073171
"6334","5/22/2012",72,3,69,4.34782608695652
"6335","5/22/2013",67,1,66,1.51515151515152
"6336","5/22/2014",74,10,64,15.625
"6337","5/22/2015",58,1,57,1.75438596491228
"6338","5/22/2016",125,2,123,1.6260162601626
"6339","5/22/2017",82,0,82,0
"6340","5/22/2018",76,1,75,1.33333333333333
"6341","5/22/2019",67,1,66,1.51515151515152
"6342","5/22/2020",66,5,61,8.19672131147541
"6343","5/22/2021",56,4,52,7.69230769230769
"6344","5/23/1994",74,2,72,2.77777777777778
"6345","5/23/1995",75,0,75,0
"6346","5/23/1996",69,1,68,1.47058823529412
"6347","5/23/1997",60,4,56,7.14285714285714
"6348","5/23/1998",67,2,65,3.07692307692308
"6349","5/23/1999",130,7,123,5.69105691056911
"6350","5/23/2000",75,3,72,4.16666666666667
"6351","5/23/2001",69,4,65,6.15384615384615
"6352","5/23/2002",74,1,73,1.36986301369863
"6353","5/23/2003",62,2,60,3.33333333333333
"6354","5/23/2004",131,2,129,1.55038759689922
"6355","5/23/2005",72,0,72,0
"6356","5/23/2006",68,0,68,0
"6357","5/23/2007",73,1,72,1.38888888888889
"6358","5/23/2008",64,2,62,3.2258064516129
"6359","5/23/2009",57,5,52,9.61538461538462
"6360","5/23/2010",130,0,130,0
"6361","5/23/2011",75,2,73,2.73972602739726
"6362","5/23/2012",76,0,76,0
"6363","5/23/2013",73,2,71,2.8169014084507
"6364","5/23/2014",51,4,47,8.51063829787234
"6365","5/23/2015",60,1,59,1.69491525423729
"6366","5/23/2016",69,1,68,1.47058823529412
"6367","5/23/2017",75,0,75,0
"6368","5/23/2018",69,5,64,7.8125
"6369","5/23/2019",75,1,74,1.35135135135135
"6370","5/23/2020",62,3,59,5.08474576271187
"6371","5/23/2021",129,3,126,2.38095238095238
"6372","5/24/1994",67,0,67,0
"6373","5/24/1995",76,0,76,0
"6374","5/24/1996",55,2,53,3.77358490566038
"6375","5/24/1997",62,1,61,1.63934426229508
"6376","5/24/1998",131,4,127,3.1496062992126
"6377","5/24/1999",74,0,74,0
"6378","5/24/2000",72,0,72,0
"6379","5/24/2001",68,3,65,4.61538461538462
"6380","5/24/2002",51,2,49,4.08163265306122
"6381","5/24/2003",60,3,57,5.26315789473684
"6382","5/24/2004",76,0,76,0
"6383","5/24/2005",70,0,70,0
"6384","5/24/2006",75,4,71,5.63380281690141
"6385","5/24/2007",73,2,71,2.8169014084507
"6386","5/24/2008",56,3,53,5.66037735849057
"6387","5/24/2009",130,5,125,4
"6388","5/24/2010",74,0,74,0
"6389","5/24/2011",69,2,67,2.98507462686567
"6390","5/24/2012",76,2,74,2.7027027027027
"6391","5/24/2013",63,2,61,3.27868852459016
"6392","5/24/2014",54,2,52,3.84615384615385
"6393","5/24/2015",163,8,155,5.16129032258065
"6394","5/24/2016",74,1,73,1.36986301369863
"6395","5/24/2017",71,2,69,2.89855072463768
"6396","5/24/2018",69,1,68,1.47058823529412
"6397","5/24/2019",68,1,67,1.49253731343284
"6398","5/24/2020",126,5,121,4.13223140495868
"6399","5/24/2021",71,0,71,0
"6400","5/25/1994",63,0,63,0
"6401","5/25/1995",72,0,72,0
"6402","5/25/1996",60,0,60,0
"6403","5/25/1997",121,5,116,4.31034482758621
"6404","5/25/1998",76,2,74,2.7027027027027
"6405","5/25/1999",66,1,65,1.53846153846154
"6406","5/25/2000",64,2,62,3.2258064516129
"6407","5/25/2001",64,3,61,4.91803278688525
"6408","5/25/2002",49,2,47,4.25531914893617
"6409","5/25/2003",158,7,151,4.63576158940397
"6410","5/25/2004",68,0,68,0
"6411","5/25/2005",75,2,73,2.73972602739726
"6412","5/25/2006",68,1,67,1.49253731343284
"6413","5/25/2007",63,2,61,3.27868852459016
"6414","5/25/2008",131,5,126,3.96825396825397
"6415","5/25/2009",67,0,67,0
"6416","5/25/2010",76,1,75,1.33333333333333
"6417","5/25/2011",62,1,61,1.63934426229508
"6418","5/25/2012",58,5,53,9.43396226415094
"6419","5/25/2013",66,10,56,17.8571428571429
"6420","5/25/2014",129,4,125,3.2
"6421","5/25/2015",73,2,71,2.8169014084507
"6422","5/25/2016",76,6,70,8.57142857142857
"6423","5/25/2017",64,1,63,1.58730158730159
"6424","5/25/2018",58,2,56,3.57142857142857
"6425","5/25/2019",63,2,61,3.27868852459016
"6426","5/25/2020",70,1,69,1.44927536231884
"6427","5/25/2021",68,4,64,6.25
"6428","5/26/1994",67,3,64,4.6875
"6429","5/26/1995",52,1,51,1.96078431372549
"6430","5/26/1996",112,0,112,0
"6431","5/26/1997",74,0,74,0
"6432","5/26/1998",74,0,74,0
"6433","5/26/1999",73,0,73,0
"6434","5/26/2000",67,5,62,8.06451612903226
"6435","5/26/2001",64,1,63,1.58730158730159
"6436","5/26/2002",128,1,127,0.78740157480315
"6437","5/26/2003",73,0,73,0
"6438","5/26/2004",71,5,66,7.57575757575758
"6439","5/26/2005",71,0,71,0
"6440","5/26/2006",65,3,62,4.83870967741935
"6441","5/26/2007",64,4,60,6.66666666666667
"6442","5/26/2008",75,0,75,0
"6443","5/26/2009",72,1,71,1.40845070422535
"6444","5/26/2010",67,0,67,0
"6445","5/26/2011",69,3,66,4.54545454545455
"6446","5/26/2012",62,7,55,12.7272727272727
"6447","5/26/2013",124,7,117,5.98290598290598
"6448","5/26/2014",73,0,73,0
"6449","5/26/2015",77,0,77,0
"6450","5/26/2016",72,3,69,4.34782608695652
"6451","5/26/2017",64,2,62,3.2258064516129
"6452","5/26/2018",62,1,61,1.63934426229508
"6453","5/26/2019",129,6,123,4.8780487804878
"6454","5/26/2020",70,0,70,0
"6455","5/26/2021",70,2,68,2.94117647058824
"6456","5/27/1994",61,2,59,3.38983050847458
"6457","5/27/1995",58,1,57,1.75438596491228
"6458","5/27/1996",75,0,75,0
"6459","5/27/1997",71,1,70,1.42857142857143
"6460","5/27/1998",73,0,73,0
"6461","5/27/1999",68,3,65,4.61538461538462
"6462","5/27/2000",55,2,53,3.77358490566038
"6463","5/27/2001",124,7,117,5.98290598290598
"6464","5/27/2002",70,0,70,0
"6465","5/27/2003",74,0,74,0
"6466","5/27/2004",74,5,69,7.2463768115942
"6467","5/27/2005",54,1,53,1.88679245283019
"6468","5/27/2006",65,6,59,10.1694915254237
"6469","5/27/2007",120,3,117,2.56410256410256
"6470","5/27/2008",73,1,72,1.38888888888889
"6471","5/27/2009",74,5,69,7.2463768115942
"6472","5/27/2010",66,3,63,4.76190476190476
"6473","5/27/2011",63,2,61,3.27868852459016
"6474","5/27/2012",113,4,109,3.6697247706422
"6475","5/27/2013",74,0,74,0
"6476","5/27/2014",75,3,72,4.16666666666667
"6477","5/27/2015",71,0,71,0
"6478","5/27/2016",65,2,63,3.17460317460317
"6479","5/27/2017",61,3,58,5.17241379310345
"6480","5/27/2018",110,2,108,1.85185185185185
"6481","5/27/2019",69,0,69,0
"6482","5/27/2020",72,0,72,0
"6483","5/27/2021",70,1,69,1.44927536231884
"6484","5/28/1994",62,2,60,3.33333333333333
"6485","5/28/1995",115,2,113,1.76991150442478
"6486","5/28/1996",74,0,74,0
"6487","5/28/1997",71,0,71,0
"6488","5/28/1998",73,3,70,4.28571428571429
"6489","5/28/1999",58,3,55,5.45454545454545
"6490","5/28/2000",128,4,124,3.2258064516129
"6491","5/28/2001",77,0,77,0
"6492","5/28/2002",75,2,73,2.73972602739726
"6493","5/28/2003",75,1,74,1.35135135135135
"6494","5/28/2004",69,8,61,13.1147540983607
"6495","5/28/2005",58,0,58,0
"6496","5/28/2006",130,3,127,2.36220472440945
"6497","5/28/2007",75,1,74,1.35135135135135
"6498","5/28/2008",74,1,73,1.36986301369863
"6499","5/28/2009",72,1,71,1.40845070422535
"6500","5/28/2010",64,6,58,10.3448275862069
"6501","5/28/2011",66,3,63,4.76190476190476
"6502","5/28/2012",75,1,74,1.35135135135135
"6503","5/28/2013",68,0,68,0
"6504","5/28/2014",63,1,62,1.61290322580645
"6505","5/28/2015",64,8,56,14.2857142857143
"6506","5/28/2016",60,5,55,9.09090909090909
"6507","5/28/2017",129,7,122,5.73770491803279
"6508","5/28/2018",64,3,61,4.91803278688525
"6509","5/28/2019",76,1,75,1.33333333333333
"6510","5/28/2020",69,0,69,0
"6511","5/28/2021",63,9,54,16.6666666666667
"6512","5/29/1994",130,1,129,0.775193798449612
"6513","5/29/1995",74,1,73,1.36986301369863
"6514","5/29/1996",75,0,75,0
"6515","5/29/1997",62,2,60,3.33333333333333
"6516","5/29/1998",60,3,57,5.26315789473684
"6517","5/29/1999",52,1,51,1.96078431372549
"6518","5/29/2000",74,0,74,0
"6519","5/29/2001",73,1,72,1.38888888888889
"6520","5/29/2002",69,3,66,4.54545454545455
"6521","5/29/2003",70,3,67,4.47761194029851
"6522","5/29/2004",52,2,50,4
"6523","5/29/2005",122,6,116,5.17241379310345
"6524","5/29/2006",72,0,72,0
"6525","5/29/2007",71,0,71,0
"6526","5/29/2008",70,2,68,2.94117647058824
"6527","5/29/2009",61,9,52,17.3076923076923
"6528","5/29/2010",70,3,67,4.47761194029851
"6529","5/29/2011",154,4,150,2.66666666666667
"6530","5/29/2012",68,0,68,0
"6531","5/29/2013",76,0,76,0
"6532","5/29/2014",63,4,59,6.77966101694915
"6533","5/29/2015",60,3,57,5.26315789473684
"6534","5/29/2016",127,8,119,6.72268907563025
"6535","5/29/2017",71,2,69,2.89855072463768
"6536","5/29/2018",69,1,68,1.47058823529412
"6537","5/29/2019",71,2,69,2.89855072463768
"6538","5/29/2020",61,3,58,5.17241379310345
"6539","5/29/2021",60,2,58,3.44827586206897
"6540","5/3/1994",69,1,68,1.47058823529412
"6541","5/3/1995",69,0,69,0
"6542","5/3/1996",65,3,62,4.83870967741935
"6543","5/3/1997",63,3,60,5
"6544","5/3/1998",132,3,129,2.32558139534884
"6545","5/3/1999",77,0,77,0
"6546","5/3/2000",69,3,66,4.54545454545455
"6547","5/3/2001",65,1,64,1.5625
"6548","5/3/2002",67,4,63,6.34920634920635
"6549","5/3/2003",65,5,60,8.33333333333333
"6550","5/3/2004",77,0,77,0
"6551","5/3/2005",77,0,77,0
"6552","5/3/2006",69,1,68,1.47058823529412
"6553","5/3/2007",72,2,70,2.85714285714286
"6554","5/3/2008",63,2,61,3.27868852459016
"6555","5/3/2009",131,6,125,4.8
"6556","5/3/2010",73,1,72,1.38888888888889
"6557","5/3/2011",76,1,75,1.33333333333333
"6558","5/3/2012",71,3,68,4.41176470588235
"6559","5/3/2013",60,1,59,1.69491525423729
"6560","5/3/2014",53,6,47,12.7659574468085
"6561","5/3/2015",125,6,119,5.04201680672269
"6562","5/3/2016",71,5,66,7.57575757575758
"6563","5/3/2017",72,2,70,2.85714285714286
"6564","5/3/2018",71,3,68,4.41176470588235
"6565","5/3/2019",68,6,62,9.67741935483871
"6566","5/3/2020",131,2,129,1.55038759689922
"6567","5/3/2021",71,2,69,2.89855072463768
"6568","5/30/1994",73,1,72,1.38888888888889
"6569","5/30/1995",70,4,66,6.06060606060606
"6570","5/30/1996",64,0,64,0
"6571","5/30/1997",63,2,61,3.27868852459016
"6572","5/30/1998",64,1,63,1.58730158730159
"6573","5/30/1999",127,3,124,2.41935483870968
"6574","5/30/2000",76,0,76,0
"6575","5/30/2001",71,1,70,1.42857142857143
"6576","5/30/2002",67,1,66,1.51515151515152
"6577","5/30/2003",60,3,57,5.26315789473684
"6578","5/30/2004",128,4,124,3.2258064516129
"6579","5/30/2005",73,0,73,0
"6580","5/30/2006",69,0,69,0
"6581","5/30/2007",69,0,69,0
"6582","5/30/2008",60,4,56,7.14285714285714
"6583","5/30/2009",65,2,63,3.17460317460317
"6584","5/30/2010",134,1,133,0.75187969924812
"6585","5/30/2011",74,1,73,1.36986301369863
"6586","5/30/2012",76,2,74,2.7027027027027
"6587","5/30/2013",71,1,70,1.42857142857143
"6588","5/30/2014",62,5,57,8.7719298245614
"6589","5/30/2015",62,4,58,6.89655172413793
"6590","5/30/2016",73,2,71,2.8169014084507
"6591","5/30/2017",74,1,73,1.36986301369863
"6592","5/30/2018",72,1,71,1.40845070422535
"6593","5/30/2019",72,3,69,4.34782608695652
"6594","5/30/2020",62,6,56,10.7142857142857
"6595","5/30/2021",126,4,122,3.27868852459016
"6596","5/31/1994",71,1,70,1.42857142857143
"6597","5/31/1995",63,0,63,0
"6598","5/31/1996",57,2,55,3.63636363636364
"6599","5/31/1997",52,2,50,4
"6600","5/31/1998",125,3,122,2.45901639344262
"6601","5/31/1999",77,0,77,0
"6602","5/31/2000",70,0,70,0
"6603","5/31/2001",68,5,63,7.93650793650794
"6604","5/31/2002",57,2,55,3.63636363636364
"6605","5/31/2003",61,1,60,1.66666666666667
"6606","5/31/2004",74,0,74,0
"6607","5/31/2005",68,1,67,1.49253731343284
"6608","5/31/2006",74,2,72,2.77777777777778
"6609","5/31/2007",74,1,73,1.36986301369863
"6610","5/31/2008",56,6,50,12
"6611","5/31/2009",124,3,121,2.47933884297521
"6612","5/31/2010",74,1,73,1.36986301369863
"6613","5/31/2011",75,1,74,1.35135135135135
"6614","5/31/2012",73,0,73,0
"6615","5/31/2013",62,6,56,10.7142857142857
"6616","5/31/2014",61,0,61,0
"6617","5/31/2015",126,9,117,7.69230769230769
"6618","5/31/2016",75,0,75,0
"6619","5/31/2017",75,4,71,5.63380281690141
"6620","5/31/2018",71,4,67,5.97014925373134
"6621","5/31/2019",61,6,55,10.9090909090909
"6622","5/31/2020",124,4,120,3.33333333333333
"6623","5/31/2021",72,1,71,1.40845070422535
"6624","5/4/1994",73,0,73,0
"6625","5/4/1995",71,1,70,1.42857142857143
"6626","5/4/1996",56,1,55,1.81818181818182
"6627","5/4/1997",126,3,123,2.4390243902439
"6628","5/4/1998",70,0,70,0
"6629","5/4/1999",75,0,75,0
"6630","5/4/2000",71,2,69,2.89855072463768
"6631","5/4/2001",60,1,59,1.69491525423729
"6632","5/4/2002",62,2,60,3.33333333333333
"6633","5/4/2003",124,1,123,0.813008130081301
"6634","5/4/2004",70,2,68,2.94117647058824
"6635","5/4/2005",70,2,68,2.94117647058824
"6636","5/4/2006",69,1,68,1.47058823529412
"6637","5/4/2007",57,4,53,7.54716981132075
"6638","5/4/2008",126,7,119,5.88235294117647
"6639","5/4/2009",70,1,69,1.44927536231884
"6640","5/4/2010",70,1,69,1.44927536231884
"6641","5/4/2011",68,2,66,3.03030303030303
"6642","5/4/2012",66,3,63,4.76190476190476
"6643","5/4/2013",63,7,56,12.5
"6644","5/4/2014",130,6,124,4.83870967741935
"6645","5/4/2015",76,1,75,1.33333333333333
"6646","5/4/2016",71,3,68,4.41176470588235
"6647","5/4/2017",77,5,72,6.94444444444444
"6648","5/4/2018",65,5,60,8.33333333333333
"6649","5/4/2019",58,6,52,11.5384615384615
"6650","5/4/2020",73,4,69,5.79710144927536
"6651","5/4/2021",74,3,71,4.22535211267606
"6652","5/5/1994",69,0,69,0
"6653","5/5/1995",69,0,69,0
"6654","5/5/1996",124,2,122,1.63934426229508
"6655","5/5/1997",74,0,74,0
"6656","5/5/1998",76,0,76,0
"6657","5/5/1999",69,0,69,0
"6658","5/5/2000",66,1,65,1.53846153846154
"6659","5/5/2001",58,2,56,3.57142857142857
"6660","5/5/2002",120,1,119,0.840336134453782
"6661","5/5/2003",73,0,73,0
"6662","5/5/2004",76,1,75,1.33333333333333
"6663","5/5/2005",69,2,67,2.98507462686567
"6664","5/5/2006",57,2,55,3.63636363636364
"6665","5/5/2007",62,5,57,8.7719298245614
"6666","5/5/2008",69,0,69,0
"6667","5/5/2009",69,0,69,0
"6668","5/5/2010",73,1,72,1.38888888888889
"6669","5/5/2011",66,4,62,6.45161290322581
"6670","5/5/2012",60,6,54,11.1111111111111
"6671","5/5/2013",123,6,117,5.12820512820513
"6672","5/5/2014",71,0,71,0
"6673","5/5/2015",71,3,68,4.41176470588235
"6674","5/5/2016",70,5,65,7.69230769230769
"6675","5/5/2017",55,6,49,12.2448979591837
"6676","5/5/2018",71,6,65,9.23076923076923
"6677","5/5/2019",126,14,112,12.5
"6678","5/5/2020",73,2,71,2.8169014084507
"6679","5/5/2021",75,2,73,2.73972602739726
"6680","5/6/1994",62,2,60,3.33333333333333
"6681","5/6/1995",49,0,49,0
"6682","5/6/1996",76,0,76,0
"6683","5/6/1997",71,1,70,1.42857142857143
"6684","5/6/1998",71,1,70,1.42857142857143
"6685","5/6/1999",64,1,63,1.58730158730159
"6686","5/6/2000",66,2,64,3.125
"6687","5/6/2001",122,4,118,3.38983050847458
"6688","5/6/2002",72,0,72,0
"6689","5/6/2003",68,1,67,1.49253731343284
"6690","5/6/2004",76,2,74,2.7027027027027
"6691","5/6/2005",69,4,65,6.15384615384615
"6692","5/6/2006",56,3,53,5.66037735849057
"6693","5/6/2007",108,1,107,0.934579439252336
"6694","5/6/2008",77,1,76,1.31578947368421
"6695","5/6/2009",69,0,69,0
"6696","5/6/2010",65,2,63,3.17460317460317
"6697","5/6/2011",69,1,68,1.47058823529412
"6698","5/6/2012",137,4,133,3.00751879699248
"6699","5/6/2013",67,1,66,1.51515151515152
"6700","5/6/2014",68,1,67,1.49253731343284
"6701","5/6/2015",71,1,70,1.42857142857143
"6702","5/6/2016",55,1,54,1.85185185185185
"6703","5/6/2017",62,8,54,14.8148148148148
"6704","5/6/2018",128,7,121,5.78512396694215
"6705","5/6/2019",68,0,68,0
"6706","5/6/2020",72,5,67,7.46268656716418
"6707","5/6/2021",71,4,67,5.97014925373134
"6708","5/7/1994",55,0,55,0
"6709","5/7/1995",145,6,139,4.31654676258993
"6710","5/7/1996",75,2,73,2.73972602739726
"6711","5/7/1997",72,1,71,1.40845070422535
"6712","5/7/1998",69,2,67,2.98507462686567
"6713","5/7/1999",65,6,59,10.1694915254237
"6714","5/7/2000",121,3,118,2.54237288135593
"6715","5/7/2001",73,0,73,0
"6716","5/7/2002",69,0,69,0
"6717","5/7/2003",72,2,70,2.85714285714286
"6718","5/7/2004",61,1,60,1.66666666666667
"6719","5/7/2005",47,3,44,6.81818181818182
"6720","5/7/2006",122,2,120,1.66666666666667
"6721","5/7/2007",73,0,73,0
"6722","5/7/2008",73,3,70,4.28571428571429
"6723","5/7/2009",62,5,57,8.7719298245614
"6724","5/7/2010",58,6,52,11.5384615384615
"6725","5/7/2011",64,7,57,12.280701754386
"6726","5/7/2012",67,0,67,0
"6727","5/7/2013",76,0,76,0
"6728","5/7/2014",72,3,69,4.34782608695652
"6729","5/7/2015",74,2,72,2.77777777777778
"6730","5/7/2016",67,6,61,9.83606557377049
"6731","5/7/2017",124,3,121,2.47933884297521
"6732","5/7/2018",73,1,72,1.38888888888889
"6733","5/7/2019",67,0,67,0
"6734","5/7/2020",68,2,66,3.03030303030303
"6735","5/7/2021",65,2,63,3.17460317460317
"6736","5/8/1994",124,1,123,0.813008130081301
"6737","5/8/1995",75,1,74,1.35135135135135
"6738","5/8/1996",70,0,70,0
"6739","5/8/1997",65,0,65,0
"6740","5/8/1998",68,3,65,4.61538461538462
"6741","5/8/1999",66,1,65,1.53846153846154
"6742","5/8/2000",74,0,74,0
"6743","5/8/2001",68,0,68,0
"6744","5/8/2002",73,4,69,5.79710144927536
"6745","5/8/2003",72,1,71,1.40845070422535
"6746","5/8/2004",58,1,57,1.75438596491228
"6747","5/8/2005",124,2,122,1.63934426229508
"6748","5/8/2006",70,1,69,1.44927536231884
"6749","5/8/2007",73,0,73,0
"6750","5/8/2008",73,2,71,2.8169014084507
"6751","5/8/2009",58,5,53,9.43396226415094
"6752","5/8/2010",55,1,54,1.85185185185185
"6753","5/8/2011",129,5,124,4.03225806451613
"6754","5/8/2012",72,2,70,2.85714285714286
"6755","5/8/2013",72,0,72,0
"6756","5/8/2014",74,0,74,0
"6757","5/8/2015",66,3,63,4.76190476190476
"6758","5/8/2016",126,7,119,5.88235294117647
"6759","5/8/2017",74,2,72,2.77777777777778
"6760","5/8/2018",72,1,71,1.40845070422535
"6761","5/8/2019",74,4,70,5.71428571428571
"6762","5/8/2020",59,0,59,0
"6763","5/8/2021",68,5,63,7.93650793650794
"6764","5/9/1994",76,1,75,1.33333333333333
"6765","5/9/1995",73,0,73,0
"6766","5/9/1996",66,2,64,3.125
"6767","5/9/1997",65,2,63,3.17460317460317
"6768","5/9/1998",66,5,61,8.19672131147541
"6769","5/9/1999",130,2,128,1.5625
"6770","5/9/2000",75,2,73,2.73972602739726
"6771","5/9/2001",68,1,67,1.49253731343284
"6772","5/9/2002",68,3,65,4.61538461538462
"6773","5/9/2003",58,4,54,7.40740740740741
"6774","5/9/2004",123,4,119,3.36134453781513
"6775","5/9/2005",70,1,69,1.44927536231884
"6776","5/9/2006",73,3,70,4.28571428571429
"6777","5/9/2007",70,0,70,0
"6778","5/9/2008",58,2,56,3.57142857142857
"6779","5/9/2009",64,4,60,6.66666666666667
"6780","5/9/2010",124,6,118,5.08474576271187
"6781","5/9/2011",76,0,76,0
"6782","5/9/2012",72,1,71,1.40845070422535
"6783","5/9/2013",69,3,66,4.54545454545455
"6784","5/9/2014",62,2,60,3.33333333333333
"6785","5/9/2015",65,2,63,3.17460317460317
"6786","5/9/2016",70,3,67,4.47761194029851
"6787","5/9/2017",69,0,69,0
"6788","5/9/2018",72,5,67,7.46268656716418
"6789","5/9/2019",65,3,62,4.83870967741935
"6790","5/9/2020",67,6,61,9.83606557377049
"6791","5/9/2021",133,14,119,11.7647058823529
"6792","6/1/1994",72,0,72,0
"6793","6/1/1995",74,0,74,0
"6794","6/1/1996",56,7,49,14.2857142857143
"6795","6/1/1997",140,3,137,2.18978102189781
"6796","6/1/1998",73,0,73,0
"6797","6/1/1999",74,3,71,4.22535211267606
"6798","6/1/2000",66,3,63,4.76190476190476
"6799","6/1/2001",67,3,64,4.6875
"6800","6/1/2002",65,6,59,10.1694915254237
"6801","6/1/2003",128,3,125,2.4
"6802","6/1/2004",72,1,71,1.40845070422535
"6803","6/1/2005",67,2,65,3.07692307692308
"6804","6/1/2006",68,2,66,3.03030303030303
"6805","6/1/2007",63,4,59,6.77966101694915
"6806","6/1/2008",119,6,113,5.30973451327434
"6807","6/1/2009",76,2,74,2.7027027027027
"6808","6/1/2010",74,0,74,0
"6809","6/1/2011",62,4,58,6.89655172413793
"6810","6/1/2012",42,4,38,10.5263157894737
"6811","6/1/2013",69,8,61,13.1147540983607
"6812","6/1/2014",128,6,122,4.91803278688525
"6813","6/1/2015",73,0,73,0
"6814","6/1/2016",73,1,72,1.38888888888889
"6815","6/1/2017",69,5,64,7.8125
"6816","6/1/2018",60,2,58,3.44827586206897
"6817","6/1/2019",56,4,52,7.69230769230769
"6818","6/1/2020",73,1,72,1.38888888888889
"6819","6/1/2021",69,1,68,1.47058823529412
"6820","6/10/1994",70,0,70,0
"6821","6/10/1995",69,1,68,1.47058823529412
"6822","6/10/1996",73,0,73,0
"6823","6/10/1997",72,0,72,0
"6824","6/10/1998",74,0,74,0
"6825","6/10/1999",69,0,69,0
"6826","6/10/2000",70,8,62,12.9032258064516
"6827","6/10/2001",123,4,119,3.36134453781513
"6828","6/10/2002",76,0,76,0
"6829","6/10/2003",75,4,71,5.63380281690141
"6830","6/10/2004",68,0,68,0
"6831","6/10/2005",69,3,66,4.54545454545455
"6832","6/10/2006",63,2,61,3.27868852459016
"6833","6/10/2007",125,4,121,3.30578512396694
"6834","6/10/2008",73,0,73,0
"6835","6/10/2009",70,1,69,1.44927536231884
"6836","6/10/2010",70,4,66,6.06060606060606
"6837","6/10/2011",61,5,56,8.92857142857143
"6838","6/10/2012",125,8,117,6.83760683760684
"6839","6/10/2013",74,1,73,1.36986301369863
"6840","6/10/2014",73,4,69,5.79710144927536
"6841","6/10/2015",71,1,70,1.42857142857143
"6842","6/10/2016",63,5,58,8.62068965517241
"6843","6/10/2017",52,7,45,15.5555555555556
"6844","6/10/2018",132,13,119,10.9243697478992
"6845","6/10/2019",75,0,75,0
"6846","6/10/2020",71,3,68,4.41176470588235
"6847","6/10/2021",67,0,67,0
"6848","6/11/1994",62,0,62,0
"6849","6/11/1995",128,1,127,0.78740157480315
"6850","6/11/1996",69,0,69,0
"6851","6/11/1997",73,0,73,0
"6852","6/11/1998",76,3,73,4.10958904109589
"6853","6/11/1999",61,5,56,8.92857142857143
"6854","6/11/2000",130,2,128,1.5625
"6855","6/11/2001",74,0,74,0
"6856","6/11/2002",74,1,73,1.36986301369863
"6857","6/11/2003",73,3,70,4.28571428571429
"6858","6/11/2004",60,1,59,1.69491525423729
"6859","6/11/2005",72,2,70,2.85714285714286
"6860","6/11/2006",122,4,118,3.38983050847458
"6861","6/11/2007",75,1,74,1.35135135135135
"6862","6/11/2008",70,2,68,2.94117647058824
"6863","6/11/2009",78,6,72,8.33333333333333
"6864","6/11/2010",65,4,61,6.55737704918033
"6865","6/11/2011",61,5,56,8.92857142857143
"6866","6/11/2012",76,3,73,4.10958904109589
"6867","6/11/2013",71,2,69,2.89855072463768
"6868","6/11/2014",75,0,75,0
"6869","6/11/2015",68,5,63,7.93650793650794
"6870","6/11/2016",60,2,58,3.44827586206897
"6871","6/11/2017",131,0,131,0
"6872","6/11/2018",74,0,74,0
"6873","6/11/2019",74,2,72,2.77777777777778
"6874","6/11/2020",73,3,70,4.28571428571429
"6875","6/11/2021",65,2,63,3.17460317460317
"6876","6/12/1994",130,0,130,0
"6877","6/12/1995",75,0,75,0
"6878","6/12/1996",74,1,73,1.36986301369863
"6879","6/12/1997",65,5,60,8.33333333333333
"6880","6/12/1998",56,2,54,3.7037037037037
"6881","6/12/1999",54,2,52,3.84615384615385
"6882","6/12/2000",76,0,76,0
"6883","6/12/2001",76,2,74,2.7027027027027
"6884","6/12/2002",72,3,69,4.34782608695652
"6885","6/12/2003",76,2,74,2.7027027027027
"6886","6/12/2004",70,2,68,2.94117647058824
"6887","6/12/2005",133,0,133,0
"6888","6/12/2006",71,0,71,0
"6889","6/12/2007",74,0,74,0
"6890","6/12/2008",73,1,72,1.38888888888889
"6891","6/12/2009",57,4,53,7.54716981132075
"6892","6/12/2010",52,1,51,1.96078431372549
"6893","6/12/2011",129,5,124,4.03225806451613
"6894","6/12/2012",72,3,69,4.34782608695652
"6895","6/12/2013",74,1,73,1.36986301369863
"6896","6/12/2014",69,2,67,2.98507462686567
"6897","6/12/2015",64,3,61,4.91803278688525
"6898","6/12/2016",126,8,118,6.77966101694915
"6899","6/12/2017",74,2,72,2.77777777777778
"6900","6/12/2018",66,2,64,3.125
"6901","6/12/2019",70,5,65,7.69230769230769
"6902","6/12/2020",67,7,60,11.6666666666667
"6903","6/12/2021",65,2,63,3.17460317460317
"6904","6/13/1994",71,0,71,0
"6905","6/13/1995",73,2,71,2.8169014084507
"6906","6/13/1996",61,1,60,1.66666666666667
"6907","6/13/1997",63,5,58,8.62068965517241
"6908","6/13/1998",62,3,59,5.08474576271187
"6909","6/13/1999",129,3,126,2.38095238095238
"6910","6/13/2000",73,1,72,1.38888888888889
"6911","6/13/2001",70,2,68,2.94117647058824
"6912","6/13/2002",70,2,68,2.94117647058824
"6913","6/13/2003",58,3,55,5.45454545454545
"6914","6/13/2004",129,8,121,6.61157024793388
"6915","6/13/2005",75,0,75,0
"6916","6/13/2006",75,0,75,0
"6917","6/13/2007",74,0,74,0
"6918","6/13/2008",59,4,55,7.27272727272727
"6919","6/13/2009",65,3,62,4.83870967741935
"6920","6/13/2010",111,3,108,2.77777777777778
"6921","6/13/2011",77,2,75,2.66666666666667
"6922","6/13/2012",77,0,77,0
"6923","6/13/2013",72,4,68,5.88235294117647
"6924","6/13/2014",63,4,59,6.77966101694915
"6925","6/13/2015",64,2,62,3.2258064516129
"6926","6/13/2016",74,1,73,1.36986301369863
"6927","6/13/2017",71,1,70,1.42857142857143
"6928","6/13/2018",69,4,65,6.15384615384615
"6929","6/13/2019",72,5,67,7.46268656716418
"6930","6/13/2020",67,4,63,6.34920634920635
"6931","6/13/2021",127,7,120,5.83333333333333
"6932","6/14/1994",70,1,69,1.44927536231884
"6933","6/14/1995",67,1,66,1.51515151515152
"6934","6/14/1996",62,2,60,3.33333333333333
"6935","6/14/1997",63,3,60,5
"6936","6/14/1998",127,4,123,3.2520325203252
"6937","6/14/1999",73,0,73,0
"6938","6/14/2000",70,1,69,1.44927536231884
"6939","6/14/2001",67,4,63,6.34920634920635
"6940","6/14/2002",55,2,53,3.77358490566038
"6941","6/14/2003",66,5,61,8.19672131147541
"6942","6/14/2004",67,0,67,0
"6943","6/14/2005",72,1,71,1.40845070422535
"6944","6/14/2006",75,4,71,5.63380281690141
"6945","6/14/2007",72,3,69,4.34782608695652
"6946","6/14/2008",53,2,51,3.92156862745098
"6947","6/14/2009",128,3,125,2.4
"6948","6/14/2010",77,1,76,1.31578947368421
"6949","6/14/2011",71,3,68,4.41176470588235
"6950","6/14/2012",68,3,65,4.61538461538462
"6951","6/14/2013",63,5,58,8.62068965517241
"6952","6/14/2014",58,4,54,7.40740740740741
"6953","6/14/2015",117,6,111,5.40540540540541
"6954","6/14/2016",68,2,66,3.03030303030303
"6955","6/14/2017",66,1,65,1.53846153846154
"6956","6/14/2018",76,2,74,2.7027027027027
"6957","6/14/2019",63,4,59,6.77966101694915
"6958","6/14/2020",129,8,121,6.61157024793388
"6959","6/14/2021",74,3,71,4.22535211267606
"6960","6/15/1994",65,0,65,0
"6961","6/15/1995",71,1,70,1.42857142857143
"6962","6/15/1996",43,2,41,4.8780487804878
"6963","6/15/1997",133,9,124,7.25806451612903
"6964","6/15/1998",68,1,67,1.49253731343284
"6965","6/15/1999",72,1,71,1.40845070422535
"6966","6/15/2000",65,1,64,1.5625
"6967","6/15/2001",57,1,56,1.78571428571429
"6968","6/15/2002",59,2,57,3.50877192982456
"6969","6/15/2003",136,4,132,3.03030303030303
"6970","6/15/2004",74,1,73,1.36986301369863
"6971","6/15/2005",75,2,73,2.73972602739726
"6972","6/15/2006",66,1,65,1.53846153846154
"6973","6/15/2007",65,1,64,1.5625
"6974","6/15/2008",129,4,125,3.2
"6975","6/15/2009",75,2,73,2.73972602739726
"6976","6/15/2010",73,2,71,2.8169014084507
"6977","6/15/2011",66,1,65,1.53846153846154
"6978","6/15/2012",53,2,51,3.92156862745098
"6979","6/15/2013",60,7,53,13.2075471698113
"6980","6/15/2014",130,3,127,2.36220472440945
"6981","6/15/2015",75,0,75,0
"6982","6/15/2016",73,5,68,7.35294117647059
"6983","6/15/2017",67,1,66,1.51515151515152
"6984","6/15/2018",56,2,54,3.7037037037037
"6985","6/15/2019",55,2,53,3.77358490566038
"6986","6/15/2020",73,0,73,0
"6987","6/15/2021",71,2,69,2.89855072463768
"6988","6/16/1994",58,1,57,1.75438596491228
"6989","6/16/1995",56,0,56,0
"6990","6/16/1996",124,0,124,0
"6991","6/16/1997",73,0,73,0
"6992","6/16/1998",74,1,73,1.36986301369863
"6993","6/16/1999",69,2,67,2.98507462686567
"6994","6/16/2000",64,3,61,4.91803278688525
"6995","6/16/2001",64,4,60,6.66666666666667
"6996","6/16/2002",126,3,123,2.4390243902439
"6997","6/16/2003",73,0,73,0
"6998","6/16/2004",71,1,70,1.42857142857143
"6999","6/16/2005",66,4,62,6.45161290322581
"7000","6/16/2006",63,4,59,6.77966101694915
"7001","6/16/2007",68,2,66,3.03030303030303
"7002","6/16/2008",75,0,75,0
"7003","6/16/2009",67,2,65,3.07692307692308
"7004","6/16/2010",66,1,65,1.53846153846154
"7005","6/16/2011",74,9,65,13.8461538461538
"7006","6/16/2012",65,4,61,6.55737704918033
"7007","6/16/2013",124,1,123,0.813008130081301
"7008","6/16/2014",73,3,70,4.28571428571429
"7009","6/16/2015",72,1,71,1.40845070422535
"7010","6/16/2016",78,9,69,13.0434782608696
"7011","6/16/2017",61,1,60,1.66666666666667
"7012","6/16/2018",54,3,51,5.88235294117647
"7013","6/16/2019",104,3,101,2.97029702970297
"7014","6/16/2020",76,1,75,1.33333333333333
"7015","6/16/2021",74,0,74,0
"7016","6/17/1994",70,0,70,0
"7017","6/17/1995",51,1,50,2
"7018","6/17/1996",72,0,72,0
"7019","6/17/1997",75,0,75,0
"7020","6/17/1998",71,1,70,1.42857142857143
"7021","6/17/1999",69,3,66,4.54545454545455
"7022","6/17/2000",61,2,59,3.38983050847458
"7023","6/17/2001",124,2,122,1.63934426229508
"7024","6/17/2002",76,2,74,2.7027027027027
"7025","6/17/2003",79,1,78,1.28205128205128
"7026","6/17/2004",68,0,68,0
"7027","6/17/2005",56,2,54,3.7037037037037
"7028","6/17/2006",57,5,52,9.61538461538462
"7029","6/17/2007",133,3,130,2.30769230769231
"7030","6/17/2008",74,0,74,0
"7031","6/17/2009",75,2,73,2.73972602739726
"7032","6/17/2010",70,2,68,2.94117647058824
"7033","6/17/2011",56,8,48,16.6666666666667
"7034","6/17/2012",126,5,121,4.13223140495868
"7035","6/17/2013",72,0,72,0
"7036","6/17/2014",74,1,73,1.36986301369863
"7037","6/17/2015",79,3,76,3.94736842105263
"7038","6/17/2016",61,5,56,8.92857142857143
"7039","6/17/2017",55,3,52,5.76923076923077
"7040","6/17/2018",128,5,123,4.0650406504065
"7041","6/17/2019",73,1,72,1.38888888888889
"7042","6/17/2020",69,2,67,2.98507462686567
"7043","6/17/2021",70,3,67,4.47761194029851
"7044","6/18/1994",46,0,46,0
"7045","6/18/1995",125,0,125,0
"7046","6/18/1996",69,0,69,0
"7047","6/18/1997",73,0,73,0
"7048","6/18/1998",71,1,70,1.42857142857143
"7049","6/18/1999",64,1,63,1.58730158730159
"7050","6/18/2000",122,7,115,6.08695652173913
"7051","6/18/2001",77,0,77,0
"7052","6/18/2002",72,0,72,0
"7053","6/18/2003",73,3,70,4.28571428571429
"7054","6/18/2004",67,3,64,4.6875
"7055","6/18/2005",50,3,47,6.38297872340426
"7056","6/18/2006",135,7,128,5.46875
"7057","6/18/2007",72,1,71,1.40845070422535
"7058","6/18/2008",71,1,70,1.42857142857143
"7059","6/18/2009",75,7,68,10.2941176470588
"7060","6/18/2010",63,3,60,5
"7061","6/18/2011",58,4,54,7.40740740740741
"7062","6/18/2012",75,0,75,0
"7063","6/18/2013",74,5,69,7.2463768115942
"7064","6/18/2014",73,1,72,1.38888888888889
"7065","6/18/2015",64,5,59,8.47457627118644
"7066","6/18/2016",54,3,51,5.88235294117647
"7067","6/18/2017",114,3,111,2.7027027027027
"7068","6/18/2018",69,0,69,0
"7069","6/18/2019",70,1,69,1.44927536231884
"7070","6/18/2020",73,2,71,2.8169014084507
"7071","6/18/2021",65,4,61,6.55737704918033
"7072","6/19/1994",123,1,122,0.819672131147541
"7073","6/19/1995",76,0,76,0
"7074","6/19/1996",69,0,69,0
"7075","6/19/1997",69,0,69,0
"7076","6/19/1998",64,1,63,1.58730158730159
"7077","6/19/1999",59,0,59,0
"7078","6/19/2000",74,1,73,1.36986301369863
"7079","6/19/2001",74,0,74,0
"7080","6/19/2002",72,0,72,0
"7081","6/19/2003",59,2,57,3.50877192982456
"7082","6/19/2004",65,4,61,6.55737704918033
"7083","6/19/2005",125,5,120,4.16666666666667
"7084","6/19/2006",74,1,73,1.36986301369863
"7085","6/19/2007",64,0,64,0
"7086","6/19/2008",53,3,50,6
"7087","6/19/2009",62,3,59,5.08474576271187
"7088","6/19/2010",57,3,54,5.55555555555556
"7089","6/19/2011",128,5,123,4.0650406504065
"7090","6/19/2012",74,2,72,2.77777777777778
"7091","6/19/2013",72,3,69,4.34782608695652
"7092","6/19/2014",58,22,36,61.1111111111111
"7093","6/19/2015",59,5,54,9.25925925925926
"7094","6/19/2016",126,7,119,5.88235294117647
"7095","6/19/2017",75,4,71,5.63380281690141
"7096","6/19/2018",75,1,74,1.35135135135135
"7097","6/19/2019",70,6,64,9.375
"7098","6/19/2020",62,2,60,3.33333333333333
"7099","6/19/2021",66,3,63,4.76190476190476
"7100","6/2/1994",68,2,66,3.03030303030303
"7101","6/2/1995",60,0,60,0
"7102","6/2/1996",122,5,117,4.27350427350427
"7103","6/2/1997",73,1,72,1.38888888888889
"7104","6/2/1998",75,1,74,1.35135135135135
"7105","6/2/1999",69,2,67,2.98507462686567
"7106","6/2/2000",60,2,58,3.44827586206897
"7107","6/2/2001",67,3,64,4.6875
"7108","6/2/2002",121,6,115,5.21739130434783
"7109","6/2/2003",74,1,73,1.36986301369863
"7110","6/2/2004",73,0,73,0
"7111","6/2/2005",62,1,61,1.63934426229508
"7112","6/2/2006",65,2,63,3.17460317460317
"7113","6/2/2007",51,1,50,2
"7114","6/2/2008",74,2,72,2.77777777777778
"7115","6/2/2009",74,2,72,2.77777777777778
"7116","6/2/2010",73,1,72,1.38888888888889
"7117","6/2/2011",73,1,72,1.38888888888889
"7118","6/2/2012",65,7,58,12.0689655172414
"7119","6/2/2013",129,3,126,2.38095238095238
"7120","6/2/2014",78,2,76,2.63157894736842
"7121","6/2/2015",74,0,74,0
"7122","6/2/2016",72,3,69,4.34782608695652
"7123","6/2/2017",62,4,58,6.89655172413793
"7124","6/2/2018",65,8,57,14.0350877192982
"7125","6/2/2019",122,6,116,5.17241379310345
"7126","6/2/2020",68,1,67,1.49253731343284
"7127","6/2/2021",77,2,75,2.66666666666667
"7128","6/20/1994",74,0,74,0
"7129","6/20/1995",70,0,70,0
"7130","6/20/1996",68,0,68,0
"7131","6/20/1997",59,3,56,5.35714285714286
"7132","6/20/1998",65,3,62,4.83870967741935
"7133","6/20/1999",127,4,123,3.2520325203252
"7134","6/20/2000",73,4,69,5.79710144927536
"7135","6/20/2001",70,5,65,7.69230769230769
"7136","6/20/2002",70,4,66,6.06060606060606
"7137","6/20/2003",61,2,59,3.38983050847458
"7138","6/20/2004",127,1,126,0.793650793650794
"7139","6/20/2005",76,0,76,0
"7140","6/20/2006",72,0,72,0
"7141","6/20/2007",72,3,69,4.34782608695652
"7142","6/20/2008",63,10,53,18.8679245283019
"7143","6/20/2009",62,7,55,12.7272727272727
"7144","6/20/2010",125,6,119,5.04201680672269
"7145","6/20/2011",75,3,72,4.16666666666667
"7146","6/20/2012",72,0,72,0
"7147","6/20/2013",72,0,72,0
"7148","6/20/2014",58,7,51,13.7254901960784
"7149","6/20/2015",63,7,56,12.5
"7150","6/20/2016",75,1,74,1.35135135135135
"7151","6/20/2017",67,0,67,0
"7152","6/20/2018",66,2,64,3.125
"7153","6/20/2019",71,4,67,5.97014925373134
"7154","6/20/2020",64,2,62,3.2258064516129
"7155","6/20/2021",134,8,126,6.34920634920635
"7156","6/21/1994",73,0,73,0
"7157","6/21/1995",71,0,71,0
"7158","6/21/1996",60,0,60,0
"7159","6/21/1997",61,1,60,1.66666666666667
"7160","6/21/1998",124,5,119,4.20168067226891
"7161","6/21/1999",75,0,75,0
"7162","6/21/2000",72,4,68,5.88235294117647
"7163","6/21/2001",72,4,68,5.88235294117647
"7164","6/21/2002",62,1,61,1.63934426229508
"7165","6/21/2003",64,3,61,4.91803278688525
"7166","6/21/2004",76,3,73,4.10958904109589
"7167","6/21/2005",75,2,73,2.73972602739726
"7168","6/21/2006",73,5,68,7.35294117647059
"7169","6/21/2007",73,2,71,2.8169014084507
"7170","6/21/2008",60,1,59,1.69491525423729
"7171","6/21/2009",126,9,117,7.69230769230769
"7172","6/21/2010",76,0,76,0
"7173","6/21/2011",67,1,66,1.51515151515152
"7174","6/21/2012",72,2,70,2.85714285714286
"7175","6/21/2013",60,4,56,7.14285714285714
"7176","6/21/2014",53,5,48,10.4166666666667
"7177","6/21/2015",124,9,115,7.82608695652174
"7178","6/21/2016",71,2,69,2.89855072463768
"7179","6/21/2017",71,0,71,0
"7180","6/21/2018",69,6,63,9.52380952380952
"7181","6/21/2019",66,1,65,1.53846153846154
"7182","6/21/2020",125,4,121,3.30578512396694
"7183","6/21/2021",74,0,74,0
"7184","6/22/1994",67,0,67,0
"7185","6/22/1995",67,3,64,4.6875
"7186","6/22/1996",57,3,54,5.55555555555556
"7187","6/22/1997",128,2,126,1.58730158730159
"7188","6/22/1998",74,0,74,0
"7189","6/22/1999",73,1,72,1.38888888888889
"7190","6/22/2000",71,2,69,2.89855072463768
"7191","6/22/2001",66,5,61,8.19672131147541
"7192","6/22/2002",66,3,63,4.76190476190476
"7193","6/22/2003",132,4,128,3.125
"7194","6/22/2004",73,0,73,0
"7195","6/22/2005",72,3,69,4.34782608695652
"7196","6/22/2006",69,3,66,4.54545454545455
"7197","6/22/2007",64,2,62,3.2258064516129
"7198","6/22/2008",129,1,128,0.78125
"7199","6/22/2009",73,0,73,0
"7200","6/22/2010",71,0,71,0
"7201","6/22/2011",71,0,71,0
"7202","6/22/2012",66,3,63,4.76190476190476
"7203","6/22/2013",68,10,58,17.2413793103448
"7204","6/22/2014",128,4,124,3.2258064516129
"7205","6/22/2015",68,6,62,9.67741935483871
"7206","6/22/2016",71,0,71,0
"7207","6/22/2017",66,5,61,8.19672131147541
"7208","6/22/2018",62,2,60,3.33333333333333
"7209","6/22/2019",55,1,54,1.85185185185185
"7210","6/22/2020",69,1,68,1.47058823529412
"7211","6/22/2021",81,3,78,3.84615384615385
"7212","6/23/1994",76,3,73,4.10958904109589
"7213","6/23/1995",59,0,59,0
"7214","6/23/1996",123,1,122,0.819672131147541
"7215","6/23/1997",71,1,70,1.42857142857143
"7216","6/23/1998",70,0,70,0
"7217","6/23/1999",75,2,73,2.73972602739726
"7218","6/23/2000",63,5,58,8.62068965517241
"7219","6/23/2001",66,4,62,6.45161290322581
"7220","6/23/2002",122,2,120,1.66666666666667
"7221","6/23/2003",72,0,72,0
"7222","6/23/2004",75,0,75,0
"7223","6/23/2005",61,0,61,0
"7224","6/23/2006",62,4,58,6.89655172413793
"7225","6/23/2007",61,0,61,0
"7226","6/23/2008",75,0,75,0
"7227","6/23/2009",73,2,71,2.8169014084507
"7228","6/23/2010",74,2,72,2.77777777777778
"7229","6/23/2011",73,3,70,4.28571428571429
"7230","6/23/2012",59,3,56,5.35714285714286
"7231","6/23/2013",134,5,129,3.87596899224806
"7232","6/23/2014",70,0,70,0
"7233","6/23/2015",70,0,70,0
"7234","6/23/2016",66,3,63,4.76190476190476
"7235","6/23/2017",64,1,63,1.58730158730159
"7236","6/23/2018",58,3,55,5.45454545454545
"7237","6/23/2019",133,7,126,5.55555555555556
"7238","6/23/2020",70,2,68,2.94117647058824
"7239","6/23/2021",71,2,69,2.89855072463768
"7240","6/24/1994",65,2,63,3.17460317460317
"7241","6/24/1995",55,1,54,1.85185185185185
"7242","6/24/1996",73,0,73,0
"7243","6/24/1997",72,0,72,0
"7244","6/24/1998",73,2,71,2.8169014084507
"7245","6/24/1999",67,2,65,3.07692307692308
"7246","6/24/2000",65,2,63,3.17460317460317
"7247","6/24/2001",125,2,123,1.6260162601626
"7248","6/24/2002",71,1,70,1.42857142857143
"7249","6/24/2003",71,1,70,1.42857142857143
"7250","6/24/2004",73,4,69,5.79710144927536
"7251","6/24/2005",60,4,56,7.14285714285714
"7252","6/24/2006",66,4,62,6.45161290322581
"7253","6/24/2007",131,3,128,2.34375
"7254","6/24/2008",73,1,72,1.38888888888889
"7255","6/24/2009",68,1,67,1.49253731343284
"7256","6/24/2010",67,2,65,3.07692307692308
"7257","6/24/2011",60,1,59,1.69491525423729
"7258","6/24/2012",129,8,121,6.61157024793388
"7259","6/24/2013",77,0,77,0
"7260","6/24/2014",71,4,67,5.97014925373134
"7261","6/24/2015",66,1,65,1.53846153846154
"7262","6/24/2016",58,4,54,7.40740740740741
"7263","6/24/2017",64,6,58,10.3448275862069
"7264","6/24/2018",126,5,121,4.13223140495868
"7265","6/24/2019",65,0,65,0
"7266","6/24/2020",68,2,66,3.03030303030303
"7267","6/24/2021",70,5,65,7.69230769230769
"7268","6/25/1994",61,1,60,1.66666666666667
"7269","6/25/1995",127,2,125,1.6
"7270","6/25/1996",75,0,75,0
"7271","6/25/1997",73,2,71,2.8169014084507
"7272","6/25/1998",69,0,69,0
"7273","6/25/1999",64,4,60,6.66666666666667
"7274","6/25/2000",125,2,123,1.6260162601626
"7275","6/25/2001",75,0,75,0
"7276","6/25/2002",73,2,71,2.8169014084507
"7277","6/25/2003",71,0,71,0
"7278","6/25/2004",60,3,57,5.26315789473684
"7279","6/25/2005",59,3,56,5.35714285714286
"7280","6/25/2006",127,4,123,3.2520325203252
"7281","6/25/2007",73,0,73,0
"7282","6/25/2008",72,3,69,4.34782608695652
"7283","6/25/2009",69,5,64,7.8125
"7284","6/25/2010",55,4,51,7.84313725490196
"7285","6/25/2011",67,4,63,6.34920634920635
"7286","6/25/2012",75,0,75,0
"7287","6/25/2013",67,3,64,4.6875
"7288","6/25/2014",68,1,67,1.49253731343284
"7289","6/25/2015",70,4,66,6.06060606060606
"7290","6/25/2016",60,5,55,9.09090909090909
"7291","6/25/2017",132,4,128,3.125
"7292","6/25/2018",73,2,71,2.8169014084507
"7293","6/25/2019",73,3,70,4.28571428571429
"7294","6/25/2020",70,2,68,2.94117647058824
"7295","6/25/2021",54,5,49,10.2040816326531
"7296","6/26/1994",139,3,136,2.20588235294118
"7297","6/26/1995",75,1,74,1.35135135135135
"7298","6/26/1996",73,2,71,2.8169014084507
"7299","6/26/1997",70,7,63,11.1111111111111
"7300","6/26/1998",55,2,53,3.77358490566038
"7301","6/26/1999",60,3,57,5.26315789473684
"7302","6/26/2000",76,0,76,0
"7303","6/26/2001",75,2,73,2.73972602739726
"7304","6/26/2002",75,3,72,4.16666666666667
"7305","6/26/2003",70,2,68,2.94117647058824
"7306","6/26/2004",52,1,51,1.96078431372549
"7307","6/26/2005",123,0,123,0
"7308","6/26/2006",75,0,75,0
"7309","6/26/2007",72,0,72,0
"7310","6/26/2008",74,3,71,4.22535211267606
"7311","6/26/2009",62,4,58,6.89655172413793
"7312","6/26/2010",64,10,54,18.5185185185185
"7313","6/26/2011",121,1,120,0.833333333333333
"7314","6/26/2012",74,0,74,0
"7315","6/26/2013",72,4,68,5.88235294117647
"7316","6/26/2014",68,3,65,4.61538461538462
"7317","6/26/2015",63,4,59,6.77966101694915
"7318","6/26/2016",123,9,114,7.89473684210526
"7319","6/26/2017",74,4,70,5.71428571428571
"7320","6/26/2018",69,1,68,1.47058823529412
"7321","6/26/2019",72,1,71,1.40845070422535
"7322","6/26/2020",60,4,56,7.14285714285714
"7323","6/26/2021",65,6,59,10.1694915254237
"7324","6/27/1994",75,0,75,0
"7325","6/27/1995",76,1,75,1.33333333333333
"7326","6/27/1996",70,0,70,0
"7327","6/27/1997",60,3,57,5.26315789473684
"7328","6/27/1998",65,1,64,1.5625
"7329","6/27/1999",131,5,126,3.96825396825397
"7330","6/27/2000",73,4,69,5.79710144927536
"7331","6/27/2001",73,1,72,1.38888888888889
"7332","6/27/2002",62,1,61,1.63934426229508
"7333","6/27/2003",54,3,51,5.88235294117647
"7334","6/27/2004",128,2,126,1.58730158730159
"7335","6/27/2005",71,1,70,1.42857142857143
"7336","6/27/2006",73,1,72,1.38888888888889
"7337","6/27/2007",72,5,67,7.46268656716418
"7338","6/27/2008",66,3,63,4.76190476190476
"7339","6/27/2009",58,3,55,5.45454545454545
"7340","6/27/2010",129,5,124,4.03225806451613
"7341","6/27/2011",74,1,73,1.36986301369863
"7342","6/27/2012",61,5,56,8.92857142857143
"7343","6/27/2013",70,3,67,4.47761194029851
"7344","6/27/2014",63,5,58,8.62068965517241
"7345","6/27/2015",62,7,55,12.7272727272727
"7346","6/27/2016",72,0,72,0
"7347","6/27/2017",67,0,67,0
"7348","6/27/2018",69,0,69,0
"7349","6/27/2019",68,1,67,1.49253731343284
"7350","6/27/2020",56,3,53,5.66037735849057
"7351","6/27/2021",128,5,123,4.0650406504065
"7352","6/28/1994",66,0,66,0
"7353","6/28/1995",70,0,70,0
"7354","6/28/1996",64,0,64,0
"7355","6/28/1997",61,7,54,12.962962962963
"7356","6/28/1998",128,7,121,5.78512396694215
"7357","6/28/1999",71,1,70,1.42857142857143
"7358","6/28/2000",71,1,70,1.42857142857143
"7359","6/28/2001",67,3,64,4.6875
"7360","6/28/2002",64,0,64,0
"7361","6/28/2003",59,4,55,7.27272727272727
"7362","6/28/2004",71,1,70,1.42857142857143
"7363","6/28/2005",70,0,70,0
"7364","6/28/2006",70,4,66,6.06060606060606
"7365","6/28/2007",72,0,72,0
"7366","6/28/2008",53,3,50,6
"7367","6/28/2009",130,1,129,0.775193798449612
"7368","6/28/2010",76,1,75,1.33333333333333
"7369","6/28/2011",70,0,70,0
"7370","6/28/2012",68,6,62,9.67741935483871
"7371","6/28/2013",66,2,64,3.125
"7372","6/28/2014",69,2,67,2.98507462686567
"7373","6/28/2015",130,9,121,7.43801652892562
"7374","6/28/2016",73,1,72,1.38888888888889
"7375","6/28/2017",72,2,70,2.85714285714286
"7376","6/28/2018",66,4,62,6.45161290322581
"7377","6/28/2019",66,4,62,6.45161290322581
"7378","6/28/2020",131,1,130,0.769230769230769
"7379","6/28/2021",69,1,68,1.47058823529412
"7380","6/29/1994",71,1,70,1.42857142857143
"7381","6/29/1995",61,0,61,0
"7382","6/29/1996",41,1,40,2.5
"7383","6/29/1997",119,0,119,0
"7384","6/29/1998",77,0,77,0
"7385","6/29/1999",72,2,70,2.85714285714286
"7386","6/29/2000",70,0,70,0
"7387","6/29/2001",66,4,62,6.45161290322581
"7388","6/29/2002",62,3,59,5.08474576271187
"7389","6/29/2003",126,6,120,5
"7390","6/29/2004",75,0,75,0
"7391","6/29/2005",70,1,69,1.44927536231884
"7392","6/29/2006",69,3,66,4.54545454545455
"7393","6/29/2007",61,5,56,8.92857142857143
"7394","6/29/2008",130,1,129,0.775193798449612
"7395","6/29/2009",69,0,69,0
"7396","6/29/2010",76,1,75,1.33333333333333
"7397","6/29/2011",71,4,67,5.97014925373134
"7398","6/29/2012",56,3,53,5.66037735849057
"7399","6/29/2013",32,2,30,6.66666666666667
"7400","6/29/2014",114,7,107,6.54205607476635
"7401","6/29/2015",73,0,73,0
"7402","6/29/2016",71,1,70,1.42857142857143
"7403","6/29/2017",69,1,68,1.47058823529412
"7404","6/29/2018",64,4,60,6.66666666666667
"7405","6/29/2019",57,2,55,3.63636363636364
"7406","6/29/2020",71,2,69,2.89855072463768
"7407","6/29/2021",75,2,73,2.73972602739726
"7408","6/3/1994",65,1,64,1.5625
"7409","6/3/1995",54,5,49,10.2040816326531
"7410","6/3/1996",75,1,74,1.35135135135135
"7411","6/3/1997",70,1,69,1.44927536231884
"7412","6/3/1998",74,4,70,5.71428571428571
"7413","6/3/1999",69,1,68,1.47058823529412
"7414","6/3/2000",68,11,57,19.2982456140351
"7415","6/3/2001",128,7,121,5.78512396694215
"7416","6/3/2002",76,1,75,1.33333333333333
"7417","6/3/2003",75,0,75,0
"7418","6/3/2004",68,2,66,3.03030303030303
"7419","6/3/2005",66,1,65,1.53846153846154
"7420","6/3/2006",62,4,58,6.89655172413793
"7421","6/3/2007",122,4,118,3.38983050847458
"7422","6/3/2008",72,1,71,1.40845070422535
"7423","6/3/2009",75,0,75,0
"7424","6/3/2010",65,3,62,4.83870967741935
"7425","6/3/2011",67,7,60,11.6666666666667
"7426","6/3/2012",134,5,129,3.87596899224806
"7427","6/3/2013",75,0,75,0
"7428","6/3/2014",69,3,66,4.54545454545455
"7429","6/3/2015",73,3,70,4.28571428571429
"7430","6/3/2016",61,3,58,5.17241379310345
"7431","6/3/2017",60,1,59,1.69491525423729
"7432","6/3/2018",136,9,127,7.08661417322835
"7433","6/3/2019",76,0,76,0
"7434","6/3/2020",72,0,72,0
"7435","6/3/2021",79,5,74,6.75675675675676
"7436","6/30/1994",68,3,65,4.61538461538462
"7437","6/30/1995",73,1,72,1.38888888888889
"7438","6/30/1996",141,0,141,0
"7439","6/30/1997",74,2,72,2.77777777777778
"7440","6/30/1998",74,0,74,0
"7441","6/30/1999",71,3,68,4.41176470588235
"7442","6/30/2000",61,3,58,5.17241379310345
"7443","6/30/2001",51,5,46,10.8695652173913
"7444","6/30/2002",119,5,114,4.3859649122807
"7445","6/30/2003",75,2,73,2.73972602739726
"7446","6/30/2004",72,2,70,2.85714285714286
"7447","6/30/2005",68,1,67,1.49253731343284
"7448","6/30/2006",56,3,53,5.66037735849057
"7449","6/30/2007",56,1,55,1.81818181818182
"7450","6/30/2008",74,0,74,0
"7451","6/30/2009",73,1,72,1.38888888888889
"7452","6/30/2010",71,7,64,10.9375
"7453","6/30/2011",71,2,69,2.89855072463768
"7454","6/30/2012",62,4,58,6.89655172413793
"7455","6/30/2013",124,7,117,5.98290598290598
"7456","6/30/2014",76,1,75,1.33333333333333
"7457","6/30/2015",73,3,70,4.28571428571429
"7458","6/30/2016",74,3,71,4.22535211267606
"7459","6/30/2017",61,4,57,7.01754385964912
"7460","6/30/2018",61,7,54,12.962962962963
"7461","6/30/2019",129,6,123,4.8780487804878
"7462","6/30/2020",70,0,70,0
"7463","6/30/2021",72,2,70,2.85714285714286
"7464","6/4/1994",66,3,63,4.76190476190476
"7465","6/4/1995",135,0,135,0
"7466","6/4/1996",76,0,76,0
"7467","6/4/1997",72,1,71,1.40845070422535
"7468","6/4/1998",72,2,70,2.85714285714286
"7469","6/4/1999",63,1,62,1.61290322580645
"7470","6/4/2000",112,1,111,0.900900900900901
"7471","6/4/2001",68,0,68,0
"7472","6/4/2002",75,0,75,0
"7473","6/4/2003",71,1,70,1.42857142857143
"7474","6/4/2004",65,4,61,6.55737704918033
"7475","6/4/2005",53,7,46,15.2173913043478
"7476","6/4/2006",132,7,125,5.6
"7477","6/4/2007",76,1,75,1.33333333333333
"7478","6/4/2008",74,0,74,0
"7479","6/4/2009",64,3,61,4.91803278688525
"7480","6/4/2010",65,5,60,8.33333333333333
"7481","6/4/2011",71,2,69,2.89855072463768
"7482","6/4/2012",76,0,76,0
"7483","6/4/2013",77,0,77,0
"7484","6/4/2014",77,1,76,1.31578947368421
"7485","6/4/2015",63,3,60,5
"7486","6/4/2016",55,3,52,5.76923076923077
"7487","6/4/2017",124,3,121,2.47933884297521
"7488","6/4/2018",75,0,75,0
"7489","6/4/2019",68,2,66,3.03030303030303
"7490","6/4/2020",67,0,67,0
"7491","6/4/2021",64,4,60,6.66666666666667
"7492","6/5/1994",116,0,116,0
"7493","6/5/1995",72,0,72,0
"7494","6/5/1996",72,1,71,1.40845070422535
"7495","6/5/1997",66,0,66,0
"7496","6/5/1998",63,3,60,5
"7497","6/5/1999",66,3,63,4.76190476190476
"7498","6/5/2000",75,0,75,0
"7499","6/5/2001",75,0,75,0
"7500","6/5/2002",73,3,70,4.28571428571429
"7501","6/5/2003",68,1,67,1.49253731343284
"7502","6/5/2004",45,4,41,9.75609756097561
"7503","6/5/2005",132,1,131,0.763358778625954
"7504","6/5/2006",75,0,75,0
"7505","6/5/2007",74,0,74,0
"7506","6/5/2008",70,4,66,6.06060606060606
"7507","6/5/2009",57,5,52,9.61538461538462
"7508","6/5/2010",69,2,67,2.98507462686567
"7509","6/5/2011",133,4,129,3.10077519379845
"7510","6/5/2012",67,1,66,1.51515151515152
"7511","6/5/2013",68,2,66,3.03030303030303
"7512","6/5/2014",70,3,67,4.47761194029851
"7513","6/5/2015",66,1,65,1.53846153846154
"7514","6/5/2016",135,13,122,10.655737704918
"7515","6/5/2017",72,0,72,0
"7516","6/5/2018",63,3,60,5
"7517","6/5/2019",67,0,67,0
"7518","6/5/2020",60,4,56,7.14285714285714
"7519","6/5/2021",59,4,55,7.27272727272727
"7520","6/6/1994",70,1,69,1.44927536231884
"7521","6/6/1995",75,0,75,0
"7522","6/6/1996",64,0,64,0
"7523","6/6/1997",62,0,62,0
"7524","6/6/1998",65,1,64,1.5625
"7525","6/6/1999",158,6,152,3.94736842105263
"7526","6/6/2000",71,1,70,1.42857142857143
"7527","6/6/2001",75,5,70,7.14285714285714
"7528","6/6/2002",71,3,68,4.41176470588235
"7529","6/6/2003",67,4,63,6.34920634920635
"7530","6/6/2004",131,4,127,3.1496062992126
"7531","6/6/2005",72,0,72,0
"7532","6/6/2006",72,2,70,2.85714285714286
"7533","6/6/2007",74,3,71,4.22535211267606
"7534","6/6/2008",65,7,58,12.0689655172414
"7535","6/6/2009",69,5,64,7.8125
"7536","6/6/2010",124,4,120,3.33333333333333
"7537","6/6/2011",76,0,76,0
"7538","6/6/2012",67,2,65,3.07692307692308
"7539","6/6/2013",76,3,73,4.10958904109589
"7540","6/6/2014",58,5,53,9.43396226415094
"7541","6/6/2015",67,4,63,6.34920634920635
"7542","6/6/2016",75,0,75,0
"7543","6/6/2017",71,5,66,7.57575757575758
"7544","6/6/2018",73,1,72,1.38888888888889
"7545","6/6/2019",72,2,70,2.85714285714286
"7546","6/6/2020",65,4,61,6.55737704918033
"7547","6/6/2021",112,10,102,9.80392156862745
"7548","6/7/1994",69,0,69,0
"7549","6/7/1995",66,2,64,3.125
"7550","6/7/1996",62,0,62,0
"7551","6/7/1997",58,0,58,0
"7552","6/7/1998",127,2,125,1.6
"7553","6/7/1999",74,0,74,0
"7554","6/7/2000",66,0,66,0
"7555","6/7/2001",61,2,59,3.38983050847458
"7556","6/7/2002",58,4,54,7.40740740740741
"7557","6/7/2003",57,3,54,5.55555555555556
"7558","6/7/2004",72,0,72,0
"7559","6/7/2005",73,1,72,1.38888888888889
"7560","6/7/2006",73,1,72,1.38888888888889
"7561","6/7/2007",71,1,70,1.42857142857143
"7562","6/7/2008",57,3,54,5.55555555555556
"7563","6/7/2009",113,2,111,1.8018018018018
"7564","6/7/2010",72,0,72,0
"7565","6/7/2011",68,3,65,4.61538461538462
"7566","6/7/2012",64,1,63,1.58730158730159
"7567","6/7/2013",62,3,59,5.08474576271187
"7568","6/7/2014",67,7,60,11.6666666666667
"7569","6/7/2015",128,8,120,6.66666666666667
"7570","6/7/2016",69,0,69,0
"7571","6/7/2017",61,0,61,0
"7572","6/7/2018",67,2,65,3.07692307692308
"7573","6/7/2019",67,5,62,8.06451612903226
"7574","6/7/2020",122,10,112,8.92857142857143
"7575","6/7/2021",78,1,77,1.2987012987013
"7576","6/8/1994",66,1,65,1.53846153846154
"7577","6/8/1995",70,1,69,1.44927536231884
"7578","6/8/1996",57,1,56,1.78571428571429
"7579","6/8/1997",122,4,118,3.38983050847458
"7580","6/8/1998",71,0,71,0
"7581","6/8/1999",72,4,68,5.88235294117647
"7582","6/8/2000",67,1,66,1.51515151515152
"7583","6/8/2001",66,7,59,11.864406779661
"7584","6/8/2002",63,2,61,3.27868852459016
"7585","6/8/2003",128,5,123,4.0650406504065
"7586","6/8/2004",71,0,71,0
"7587","6/8/2005",69,3,66,4.54545454545455
"7588","6/8/2006",66,2,64,3.125
"7589","6/8/2007",59,2,57,3.50877192982456
"7590","6/8/2008",128,2,126,1.58730158730159
"7591","6/8/2009",75,0,75,0
"7592","6/8/2010",74,4,70,5.71428571428571
"7593","6/8/2011",74,2,72,2.77777777777778
"7594","6/8/2012",61,4,57,7.01754385964912
"7595","6/8/2013",58,5,53,9.43396226415094
"7596","6/8/2014",131,5,126,3.96825396825397
"7597","6/8/2015",73,1,72,1.38888888888889
"7598","6/8/2016",71,1,70,1.42857142857143
"7599","6/8/2017",61,5,56,8.92857142857143
"7600","6/8/2018",58,2,56,3.57142857142857
"7601","6/8/2019",66,5,61,8.19672131147541
"7602","6/8/2020",71,1,70,1.42857142857143
"7603","6/8/2021",60,1,59,1.69491525423729
"7604","6/9/1994",68,1,67,1.49253731343284
"7605","6/9/1995",61,2,59,3.38983050847458
"7606","6/9/1996",119,1,118,0.847457627118644
"7607","6/9/1997",72,0,72,0
"7608","6/9/1998",71,1,70,1.42857142857143
"7609","6/9/1999",72,1,71,1.40845070422535
"7610","6/9/2000",60,8,52,15.3846153846154
"7611","6/9/2001",61,2,59,3.38983050847458
"7612","6/9/2002",122,3,119,2.52100840336134
"7613","6/9/2003",76,1,75,1.33333333333333
"7614","6/9/2004",74,4,70,5.71428571428571
"7615","6/9/2005",70,3,67,4.47761194029851
"7616","6/9/2006",60,3,57,5.26315789473684
"7617","6/9/2007",65,1,64,1.5625
"7618","6/9/2008",71,1,70,1.42857142857143
"7619","6/9/2009",75,2,73,2.73972602739726
"7620","6/9/2010",69,0,69,0
"7621","6/9/2011",64,6,58,10.3448275862069
"7622","6/9/2012",57,5,52,9.61538461538462
"7623","6/9/2013",127,7,120,5.83333333333333
"7624","6/9/2014",76,1,75,1.33333333333333
"7625","6/9/2015",75,0,75,0
"7626","6/9/2016",71,4,67,5.97014925373134
"7627","6/9/2017",63,3,60,5
"7628","6/9/2018",54,2,52,3.84615384615385
"7629","6/9/2019",129,4,125,3.2
"7630","6/9/2020",75,4,71,5.63380281690141
"7631","6/9/2021",62,3,59,5.08474576271187
"7632","7/1/1994",66,0,66,0
"7633","7/1/1995",62,0,62,0
"7634","7/1/1996",74,0,74,0
"7635","7/1/1997",72,0,72,0
"7636","7/1/1998",71,0,71,0
"7637","7/1/1999",70,0,70,0
"7638","7/1/2000",68,6,62,9.67741935483871
"7639","7/1/2001",119,5,114,4.3859649122807
"7640","7/1/2002",78,1,77,1.2987012987013
"7641","7/1/2003",70,2,68,2.94117647058824
"7642","7/1/2004",71,0,71,0
"7643","7/1/2005",52,2,50,4
"7644","7/1/2006",66,1,65,1.53846153846154
"7645","7/1/2007",132,3,129,2.32558139534884
"7646","7/1/2008",70,0,70,0
"7647","7/1/2009",70,4,66,6.06060606060606
"7648","7/1/2010",73,6,67,8.95522388059701
"7649","7/1/2011",63,3,60,5
"7650","7/1/2012",134,3,131,2.29007633587786
"7651","7/1/2013",77,0,77,0
"7652","7/1/2014",76,0,76,0
"7653","7/1/2015",75,4,71,5.63380281690141
"7654","7/1/2016",65,4,61,6.55737704918033
"7655","7/1/2017",57,3,54,5.55555555555556
"7656","7/1/2018",111,8,103,7.76699029126214
"7657","7/1/2019",74,3,71,4.22535211267606
"7658","7/1/2020",69,3,66,4.54545454545455
"7659","7/1/2021",66,4,62,6.45161290322581
"7660","7/10/1994",118,3,115,2.60869565217391
"7661","7/10/1995",75,1,74,1.35135135135135
"7662","7/10/1996",67,0,67,0
"7663","7/10/1997",59,2,57,3.50877192982456
"7664","7/10/1998",66,3,63,4.76190476190476
"7665","7/10/1999",67,2,65,3.07692307692308
"7666","7/10/2000",70,0,70,0
"7667","7/10/2001",67,1,66,1.51515151515152
"7668","7/10/2002",75,6,69,8.69565217391304
"7669","7/10/2003",72,2,70,2.85714285714286
"7670","7/10/2004",58,0,58,0
"7671","7/10/2005",130,2,128,1.5625
"7672","7/10/2006",73,3,70,4.28571428571429
"7673","7/10/2007",73,1,72,1.38888888888889
"7674","7/10/2008",74,1,73,1.36986301369863
"7675","7/10/2009",57,1,56,1.78571428571429
"7676","7/10/2010",47,3,44,6.81818181818182
"7677","7/10/2011",123,7,116,6.03448275862069
"7678","7/10/2012",68,2,66,3.03030303030303
"7679","7/10/2013",73,2,71,2.8169014084507
"7680","7/10/2014",71,3,68,4.41176470588235
"7681","7/10/2015",66,4,62,6.45161290322581
"7682","7/10/2016",129,8,121,6.61157024793388
"7683","7/10/2017",73,0,73,0
"7684","7/10/2018",67,3,64,4.6875
"7685","7/10/2019",70,4,66,6.06060606060606
"7686","7/10/2020",61,5,56,8.92857142857143
"7687","7/10/2021",64,6,58,10.3448275862069
"7688","7/11/1994",75,2,73,2.73972602739726
"7689","7/11/1995",76,0,76,0
"7690","7/11/1996",62,2,60,3.33333333333333
"7691","7/11/1997",62,5,57,8.7719298245614
"7692","7/11/1998",57,2,55,3.63636363636364
"7693","7/11/1999",127,5,122,4.0983606557377
"7694","7/11/2000",72,1,71,1.40845070422535
"7695","7/11/2001",75,2,73,2.73972602739726
"7696","7/11/2002",64,2,62,3.2258064516129
"7697","7/11/2003",58,2,56,3.57142857142857
"7698","7/11/2004",115,2,113,1.76991150442478
"7699","7/11/2005",77,0,77,0
"7700","7/11/2006",67,2,65,3.07692307692308
"7701","7/11/2007",66,0,66,0
"7702","7/11/2008",68,6,62,9.67741935483871
"7703","7/11/2009",61,7,54,12.962962962963
"7704","7/11/2010",124,1,123,0.813008130081301
"7705","7/11/2011",76,1,75,1.33333333333333
"7706","7/11/2012",77,0,77,0
"7707","7/11/2013",66,3,63,4.76190476190476
"7708","7/11/2014",62,5,57,8.7719298245614
"7709","7/11/2015",61,8,53,15.0943396226415
"7710","7/11/2016",68,1,67,1.49253731343284
"7711","7/11/2017",71,2,69,2.89855072463768
"7712","7/11/2018",72,0,72,0
"7713","7/11/2019",71,5,66,7.57575757575758
"7714","7/11/2020",61,7,54,12.962962962963
"7715","7/11/2021",121,8,113,7.07964601769912
"7716","7/12/1994",74,0,74,0
"7717","7/12/1995",76,2,74,2.7027027027027
"7718","7/12/1996",63,0,63,0
"7719","7/12/1997",65,3,62,4.83870967741935
"7720","7/12/1998",116,6,110,5.45454545454545
"7721","7/12/1999",78,4,74,5.40540540540541
"7722","7/12/2000",68,1,67,1.49253731343284
"7723","7/12/2001",67,2,65,3.07692307692308
"7724","7/12/2002",67,1,66,1.51515151515152
"7725","7/12/2003",53,3,50,6
"7726","7/12/2004",75,0,75,0
"7727","7/12/2005",73,2,71,2.8169014084507
"7728","7/12/2006",72,4,68,5.88235294117647
"7729","7/12/2007",65,2,63,3.17460317460317
"7730","7/12/2008",57,4,53,7.54716981132075
"7731","7/12/2009",133,2,131,1.52671755725191
"7732","7/12/2010",71,2,69,2.89855072463768
"7733","7/12/2011",72,0,72,0
"7734","7/12/2012",71,4,67,5.97014925373134
"7735","7/12/2013",65,3,62,4.83870967741935
"7736","7/12/2014",59,3,56,5.35714285714286
"7737","7/12/2015",129,5,124,4.03225806451613
"7738","7/12/2016",72,2,70,2.85714285714286
"7739","7/12/2017",72,6,66,9.09090909090909
"7740","7/12/2018",71,2,69,2.89855072463768
"7741","7/12/2019",56,0,56,0
"7742","7/12/2020",125,2,123,1.6260162601626
"7743","7/12/2021",72,0,72,0
"7744","7/13/1994",71,1,70,1.42857142857143
"7745","7/13/1995",71,1,70,1.42857142857143
"7746","7/13/1996",67,2,65,3.07692307692308
"7747","7/13/1997",131,6,125,4.8
"7748","7/13/1998",74,0,74,0
"7749","7/13/1999",72,0,72,0
"7750","7/13/2000",66,2,64,3.125
"7751","7/13/2001",64,2,62,3.2258064516129
"7752","7/13/2002",56,1,55,1.81818181818182
"7753","7/13/2003",134,5,129,3.87596899224806
"7754","7/13/2004",74,0,74,0
"7755","7/13/2005",72,2,70,2.85714285714286
"7756","7/13/2006",70,2,68,2.94117647058824
"7757","7/13/2007",64,4,60,6.66666666666667
"7758","7/13/2008",120,7,113,6.19469026548673
"7759","7/13/2009",73,0,73,0
"7760","7/13/2010",71,0,71,0
"7761","7/13/2011",71,4,67,5.97014925373134
"7762","7/13/2012",65,2,63,3.17460317460317
"7763","7/13/2013",52,4,48,8.33333333333333
"7764","7/13/2014",128,7,121,5.78512396694215
"7765","7/13/2015",73,0,73,0
"7766","7/13/2016",74,7,67,10.4477611940298
"7767","7/13/2017",71,2,69,2.89855072463768
"7768","7/13/2018",70,2,68,2.94117647058824
"7769","7/13/2019",67,5,62,8.06451612903226
"7770","7/13/2020",72,1,71,1.40845070422535
"7771","7/13/2021",73,4,69,5.79710144927536
"7772","7/14/1994",64,1,63,1.58730158730159
"7773","7/14/1995",66,1,65,1.53846153846154
"7774","7/14/1996",132,5,127,3.93700787401575
"7775","7/14/1997",70,0,70,0
"7776","7/14/1998",72,0,72,0
"7777","7/14/1999",73,3,70,4.28571428571429
"7778","7/14/2000",62,7,55,12.7272727272727
"7779","7/14/2001",58,4,54,7.40740740740741
"7780","7/14/2002",123,3,120,2.5
"7781","7/14/2003",71,1,70,1.42857142857143
"7782","7/14/2004",68,7,61,11.4754098360656
"7783","7/14/2005",73,3,70,4.28571428571429
"7784","7/14/2006",66,4,62,6.45161290322581
"7785","7/14/2007",62,4,58,6.89655172413793
"7786","7/14/2008",73,1,72,1.38888888888889
"7787","7/14/2009",76,1,75,1.33333333333333
"7788","7/14/2010",68,1,67,1.49253731343284
"7789","7/14/2011",67,3,64,4.6875
"7790","7/14/2012",64,6,58,10.3448275862069
"7791","7/14/2013",127,4,123,3.2520325203252
"7792","7/14/2014",68,0,68,0
"7793","7/14/2015",74,1,73,1.36986301369863
"7794","7/14/2016",74,5,69,7.2463768115942
"7795","7/14/2017",53,4,49,8.16326530612245
"7796","7/14/2018",56,2,54,3.7037037037037
"7797","7/14/2019",127,7,120,5.83333333333333
"7798","7/14/2020",74,2,72,2.77777777777778
"7799","7/14/2021",67,5,62,8.06451612903226
"7800","7/15/1994",62,1,61,1.63934426229508
"7801","7/15/1995",54,0,54,0
"7802","7/15/1996",75,0,75,0
"7803","7/15/1997",72,0,72,0
"7804","7/15/1998",70,1,69,1.44927536231884
"7805","7/15/1999",71,3,68,4.41176470588235
"7806","7/15/2000",68,2,66,3.03030303030303
"7807","7/15/2001",124,8,116,6.89655172413793
"7808","7/15/2002",74,0,74,0
"7809","7/15/2003",70,0,70,0
"7810","7/15/2004",70,0,70,0
"7811","7/15/2005",66,3,63,4.76190476190476
"7812","7/15/2006",51,2,49,4.08163265306122
"7813","7/15/2007",128,6,122,4.91803278688525
"7814","7/15/2008",73,0,73,0
"7815","7/15/2009",71,3,68,4.41176470588235
"7816","7/15/2010",72,3,69,4.34782608695652
"7817","7/15/2011",59,8,51,15.6862745098039
"7818","7/15/2012",114,9,105,8.57142857142857
"7819","7/15/2013",71,0,71,0
"7820","7/15/2014",75,2,73,2.73972602739726
"7821","7/15/2015",74,1,73,1.36986301369863
"7822","7/15/2016",64,6,58,10.3448275862069
"7823","7/15/2017",65,8,57,14.0350877192982
"7824","7/15/2018",103,9,94,9.57446808510638
"7825","7/15/2019",73,0,73,0
"7826","7/15/2020",67,3,64,4.6875
"7827","7/15/2021",71,4,67,5.97014925373134
"7828","7/16/1994",68,2,66,3.03030303030303
"7829","7/16/1995",158,3,155,1.93548387096774
"7830","7/16/1996",69,0,69,0
"7831","7/16/1997",71,0,71,0
"7832","7/16/1998",70,1,69,1.44927536231884
"7833","7/16/1999",63,3,60,5
"7834","7/16/2000",123,4,119,3.36134453781513
"7835","7/16/2001",72,2,70,2.85714285714286
"7836","7/16/2002",76,1,75,1.33333333333333
"7837","7/16/2003",76,3,73,4.10958904109589
"7838","7/16/2004",60,4,56,7.14285714285714
"7839","7/16/2005",58,3,55,5.45454545454545
"7840","7/16/2006",132,6,126,4.76190476190476
"7841","7/16/2007",73,0,73,0
"7842","7/16/2008",60,3,57,5.26315789473684
"7843","7/16/2009",63,3,60,5
"7844","7/16/2010",62,4,58,6.89655172413793
"7845","7/16/2011",55,2,53,3.77358490566038
"7846","7/16/2012",75,1,74,1.35135135135135
"7847","7/16/2013",73,1,72,1.38888888888889
"7848","7/16/2014",75,1,74,1.35135135135135
"7849","7/16/2015",65,7,58,12.0689655172414
"7850","7/16/2016",52,3,49,6.12244897959184
"7851","7/16/2017",125,4,121,3.30578512396694
"7852","7/16/2018",71,0,71,0
"7853","7/16/2019",68,0,68,0
"7854","7/16/2020",71,4,67,5.97014925373134
"7855","7/16/2021",64,3,61,4.91803278688525
"7856","7/17/1994",128,4,124,3.2258064516129
"7857","7/17/1995",73,0,73,0
"7858","7/17/1996",69,2,67,2.98507462686567
"7859","7/17/1997",72,2,70,2.85714285714286
"7860","7/17/1998",58,1,57,1.75438596491228
"7861","7/17/1999",60,3,57,5.26315789473684
"7862","7/17/2000",72,0,72,0
"7863","7/17/2001",76,1,75,1.33333333333333
"7864","7/17/2002",66,3,63,4.76190476190476
"7865","7/17/2003",68,1,67,1.49253731343284
"7866","7/17/2004",67,1,66,1.51515151515152
"7867","7/17/2005",124,5,119,4.20168067226891
"7868","7/17/2006",71,1,70,1.42857142857143
"7869","7/17/2007",76,1,75,1.33333333333333
"7870","7/17/2008",76,2,74,2.7027027027027
"7871","7/17/2009",66,5,61,8.19672131147541
"7872","7/17/2010",53,10,43,23.2558139534884
"7873","7/17/2011",134,3,131,2.29007633587786
"7874","7/17/2012",74,3,71,4.22535211267606
"7875","7/17/2013",73,1,72,1.38888888888889
"7876","7/17/2014",72,8,64,12.5
"7877","7/17/2015",62,5,57,8.7719298245614
"7878","7/17/2016",132,5,127,3.93700787401575
"7879","7/17/2017",75,2,73,2.73972602739726
"7880","7/17/2018",75,0,75,0
"7881","7/17/2019",72,3,69,4.34782608695652
"7882","7/17/2020",56,3,53,5.66037735849057
"7883","7/17/2021",56,2,54,3.7037037037037
"7884","7/18/1994",70,1,69,1.44927536231884
"7885","7/18/1995",69,0,69,0
"7886","7/18/1996",72,1,71,1.40845070422535
"7887","7/18/1997",65,4,61,6.55737704918033
"7888","7/18/1998",62,5,57,8.7719298245614
"7889","7/18/1999",119,5,114,4.3859649122807
"7890","7/18/2000",73,1,72,1.38888888888889
"7891","7/18/2001",71,4,67,5.97014925373134
"7892","7/18/2002",67,2,65,3.07692307692308
"7893","7/18/2003",61,4,57,7.01754385964912
"7894","7/18/2004",132,4,128,3.125
"7895","7/18/2005",77,0,77,0
"7896","7/18/2006",77,1,76,1.31578947368421
"7897","7/18/2007",75,2,73,2.73972602739726
"7898","7/18/2008",60,4,56,7.14285714285714
"7899","7/18/2009",50,3,47,6.38297872340426
"7900","7/18/2010",126,3,123,2.4390243902439
"7901","7/18/2011",76,0,76,0
"7902","7/18/2012",73,2,71,2.8169014084507
"7903","7/18/2013",73,6,67,8.95522388059701
"7904","7/18/2014",58,5,53,9.43396226415094
"7905","7/18/2015",45,2,43,4.65116279069767
"7906","7/18/2016",70,0,70,0
"7907","7/18/2017",66,4,62,6.45161290322581
"7908","7/18/2018",70,4,66,6.06060606060606
"7909","7/18/2019",70,7,63,11.1111111111111
"7910","7/18/2020",63,5,58,8.62068965517241
"7911","7/18/2021",134,3,131,2.29007633587786
"7912","7/19/1994",70,1,69,1.44927536231884
"7913","7/19/1995",74,1,73,1.36986301369863
"7914","7/19/1996",68,2,66,3.03030303030303
"7915","7/19/1997",62,0,62,0
"7916","7/19/1998",123,2,121,1.65289256198347
"7917","7/19/1999",78,0,78,0
"7918","7/19/2000",70,5,65,7.69230769230769
"7919","7/19/2001",68,5,63,7.93650793650794
"7920","7/19/2002",53,1,52,1.92307692307692
"7921","7/19/2003",64,3,61,4.91803278688525
"7922","7/19/2004",69,0,69,0
"7923","7/19/2005",73,1,72,1.38888888888889
"7924","7/19/2006",73,3,70,4.28571428571429
"7925","7/19/2007",69,1,68,1.47058823529412
"7926","7/19/2008",65,4,61,6.55737704918033
"7927","7/19/2009",124,7,117,5.98290598290598
"7928","7/19/2010",69,0,69,0
"7929","7/19/2011",71,6,65,9.23076923076923
"7930","7/19/2012",70,3,67,4.47761194029851
"7931","7/19/2013",61,5,56,8.92857142857143
"7932","7/19/2014",63,4,59,6.77966101694915
"7933","7/19/2015",117,1,116,0.862068965517241
"7934","7/19/2016",76,2,74,2.7027027027027
"7935","7/19/2017",69,3,66,4.54545454545455
"7936","7/19/2018",75,2,73,2.73972602739726
"7937","7/19/2019",62,3,59,5.08474576271187
"7938","7/19/2020",121,0,121,0
"7939","7/19/2021",73,1,72,1.38888888888889
"7940","7/2/1994",68,2,66,3.03030303030303
"7941","7/2/1995",120,1,119,0.840336134453782
"7942","7/2/1996",72,0,72,0
"7943","7/2/1997",70,3,67,4.47761194029851
"7944","7/2/1998",70,4,66,6.06060606060606
"7945","7/2/1999",57,5,52,9.61538461538462
"7946","7/2/2000",127,5,122,4.0983606557377
"7947","7/2/2001",77,0,77,0
"7948","7/2/2002",70,1,69,1.44927536231884
"7949","7/2/2003",73,2,71,2.8169014084507
"7950","7/2/2004",61,4,57,7.01754385964912
"7951","7/2/2005",56,3,53,5.66037735849057
"7952","7/2/2006",122,7,115,6.08695652173913
"7953","7/2/2007",74,0,74,0
"7954","7/2/2008",75,0,75,0
"7955","7/2/2009",64,2,62,3.2258064516129
"7956","7/2/2010",69,4,65,6.15384615384615
"7957","7/2/2011",67,2,65,3.07692307692308
"7958","7/2/2012",71,1,70,1.42857142857143
"7959","7/2/2013",70,1,69,1.44927536231884
"7960","7/2/2014",68,0,68,0
"7961","7/2/2015",74,9,65,13.8461538461538
"7962","7/2/2016",62,4,58,6.89655172413793
"7963","7/2/2017",133,4,129,3.10077519379845
"7964","7/2/2018",73,0,73,0
"7965","7/2/2019",75,0,75,0
"7966","7/2/2020",77,5,72,6.94444444444444
"7967","7/2/2021",62,2,60,3.33333333333333
"7968","7/20/1994",73,2,71,2.8169014084507
"7969","7/20/1995",66,0,66,0
"7970","7/20/1996",60,0,60,0
"7971","7/20/1997",124,2,122,1.63934426229508
"7972","7/20/1998",81,0,81,0
"7973","7/20/1999",73,0,73,0
"7974","7/20/2000",74,3,71,4.22535211267606
"7975","7/20/2001",65,5,60,8.33333333333333
"7976","7/20/2002",61,2,59,3.38983050847458
"7977","7/20/2003",125,7,118,5.93220338983051
"7978","7/20/2004",71,0,71,0
"7979","7/20/2005",67,1,66,1.51515151515152
"7980","7/20/2006",72,7,65,10.7692307692308
"7981","7/20/2007",65,5,60,8.33333333333333
"7982","7/20/2008",124,2,122,1.63934426229508
"7983","7/20/2009",72,1,71,1.40845070422535
"7984","7/20/2010",71,2,69,2.89855072463768
"7985","7/20/2011",74,2,72,2.77777777777778
"7986","7/20/2012",60,6,54,11.1111111111111
"7987","7/20/2013",65,6,59,10.1694915254237
"7988","7/20/2014",148,2,146,1.36986301369863
"7989","7/20/2015",72,0,72,0
"7990","7/20/2016",73,2,71,2.8169014084507
"7991","7/20/2017",67,5,62,8.06451612903226
"7992","7/20/2018",60,4,56,7.14285714285714
"7993","7/20/2019",55,4,51,7.84313725490196
"7994","7/20/2020",73,0,73,0
"7995","7/20/2021",71,5,66,7.57575757575758
"7996","7/21/1994",75,1,74,1.35135135135135
"7997","7/21/1995",62,1,61,1.63934426229508
"7998","7/21/1996",119,0,119,0
"7999","7/21/1997",74,0,74,0
"8000","7/21/1998",69,1,68,1.47058823529412
"8001","7/21/1999",71,0,71,0
"8002","7/21/2000",67,2,65,3.07692307692308
"8003","7/21/2001",59,4,55,7.27272727272727
"8004","7/21/2002",120,3,117,2.56410256410256
"8005","7/21/2003",75,1,74,1.35135135135135
"8006","7/21/2004",73,3,70,4.28571428571429
"8007","7/21/2005",68,2,66,3.03030303030303
"8008","7/21/2006",65,4,61,6.55737704918033
"8009","7/21/2007",53,5,48,10.4166666666667
"8010","7/21/2008",72,0,72,0
"8011","7/21/2009",67,0,67,0
"8012","7/21/2010",73,1,72,1.38888888888889
"8013","7/21/2011",70,3,67,4.47761194029851
"8014","7/21/2012",59,3,56,5.35714285714286
"8015","7/21/2013",123,6,117,5.12820512820513
"8016","7/21/2014",72,0,72,0
"8017","7/21/2015",67,5,62,8.06451612903226
"8018","7/21/2016",67,3,64,4.6875
"8019","7/21/2017",62,1,61,1.63934426229508
"8020","7/21/2018",56,7,49,14.2857142857143
"8021","7/21/2019",130,6,124,4.83870967741935
"8022","7/21/2020",75,1,74,1.35135135135135
"8023","7/21/2021",62,3,59,5.08474576271187
"8024","7/22/1994",55,1,54,1.85185185185185
"8025","7/22/1995",65,0,65,0
"8026","7/22/1996",77,0,77,0
"8027","7/22/1997",72,1,71,1.40845070422535
"8028","7/22/1998",74,1,73,1.36986301369863
"8029","7/22/1999",68,1,67,1.49253731343284
"8030","7/22/2000",60,2,58,3.44827586206897
"8031","7/22/2001",124,7,117,5.98290598290598
"8032","7/22/2002",72,1,71,1.40845070422535
"8033","7/22/2003",74,2,72,2.77777777777778
"8034","7/22/2004",71,1,70,1.42857142857143
"8035","7/22/2005",62,3,59,5.08474576271187
"8036","7/22/2006",56,2,54,3.7037037037037
"8037","7/22/2007",125,0,125,0
"8038","7/22/2008",73,1,72,1.38888888888889
"8039","7/22/2009",72,3,69,4.34782608695652
"8040","7/22/2010",63,3,60,5
"8041","7/22/2011",51,4,47,8.51063829787234
"8042","7/22/2012",127,5,122,4.0983606557377
"8043","7/22/2013",77,0,77,0
"8044","7/22/2014",74,3,71,4.22535211267606
"8045","7/22/2015",74,1,73,1.36986301369863
"8046","7/22/2016",64,5,59,8.47457627118644
"8047","7/22/2017",63,4,59,6.77966101694915
"8048","7/22/2018",130,5,125,4
"8049","7/22/2019",75,3,72,4.16666666666667
"8050","7/22/2020",69,2,67,2.98507462686567
"8051","7/22/2021",69,2,67,2.98507462686567
"8052","7/23/1994",60,2,58,3.44827586206897
"8053","7/23/1995",126,0,126,0
"8054","7/23/1996",75,0,75,0
"8055","7/23/1997",71,4,67,5.97014925373134
"8056","7/23/1998",70,3,67,4.47761194029851
"8057","7/23/1999",64,4,60,6.66666666666667
"8058","7/23/2000",125,14,111,12.6126126126126
"8059","7/23/2001",71,2,69,2.89855072463768
"8060","7/23/2002",74,0,74,0
"8061","7/23/2003",74,2,72,2.77777777777778
"8062","7/23/2004",66,3,63,4.76190476190476
"8063","7/23/2005",61,3,58,5.17241379310345
"8064","7/23/2006",126,4,122,3.27868852459016
"8065","7/23/2007",74,3,71,4.22535211267606
"8066","7/23/2008",71,1,70,1.42857142857143
"8067","7/23/2009",80,2,78,2.56410256410256
"8068","7/23/2010",66,3,63,4.76190476190476
"8069","7/23/2011",67,9,58,15.5172413793103
"8070","7/23/2012",75,0,75,0
"8071","7/23/2013",74,1,73,1.36986301369863
"8072","7/23/2014",72,2,70,2.85714285714286
"8073","7/23/2015",70,2,68,2.94117647058824
"8074","7/23/2016",67,3,64,4.6875
"8075","7/23/2017",132,6,126,4.76190476190476
"8076","7/23/2018",72,1,71,1.40845070422535
"8077","7/23/2019",70,2,68,2.94117647058824
"8078","7/23/2020",74,5,69,7.2463768115942
"8079","7/23/2021",65,5,60,8.33333333333333
"8080","7/24/1994",117,0,117,0
"8081","7/24/1995",71,2,69,2.89855072463768
"8082","7/24/1996",69,0,69,0
"8083","7/24/1997",76,1,75,1.33333333333333
"8084","7/24/1998",59,0,59,0
"8085","7/24/1999",62,2,60,3.33333333333333
"8086","7/24/2000",76,0,76,0
"8087","7/24/2001",72,5,67,7.46268656716418
"8088","7/24/2002",70,2,68,2.94117647058824
"8089","7/24/2003",67,2,65,3.07692307692308
"8090","7/24/2004",68,1,67,1.49253731343284
"8091","7/24/2005",123,5,118,4.23728813559322
"8092","7/24/2006",73,0,73,0
"8093","7/24/2007",68,0,68,0
"8094","7/24/2008",67,1,66,1.51515151515152
"8095","7/24/2009",52,1,51,1.96078431372549
"8096","7/24/2010",64,0,64,0
"8097","7/24/2011",130,6,124,4.83870967741935
"8098","7/24/2012",72,0,72,0
"8099","7/24/2013",67,5,62,8.06451612903226
"8100","7/24/2014",65,3,62,4.83870967741935
"8101","7/24/2015",60,5,55,9.09090909090909
"8102","7/24/2016",129,5,124,4.03225806451613
"8103","7/24/2017",74,2,72,2.77777777777778
"8104","7/24/2018",75,3,72,4.16666666666667
"8105","7/24/2019",70,5,65,7.69230769230769
"8106","7/24/2020",57,3,54,5.55555555555556
"8107","7/24/2021",62,5,57,8.7719298245614
"8108","7/25/1994",70,1,69,1.44927536231884
"8109","7/25/1995",73,0,73,0
"8110","7/25/1996",65,0,65,0
"8111","7/25/1997",65,2,63,3.17460317460317
"8112","7/25/1998",61,0,61,0
"8113","7/25/1999",124,4,120,3.33333333333333
"8114","7/25/2000",72,0,72,0
"8115","7/25/2001",74,1,73,1.36986301369863
"8116","7/25/2002",64,1,63,1.58730158730159
"8117","7/25/2003",68,4,64,6.25
"8118","7/25/2004",124,1,123,0.813008130081301
"8119","7/25/2005",74,2,72,2.77777777777778
"8120","7/25/2006",74,0,74,0
"8121","7/25/2007",72,1,71,1.40845070422535
"8122","7/25/2008",60,2,58,3.44827586206897
"8123","7/25/2009",66,5,61,8.19672131147541
"8124","7/25/2010",128,4,124,3.2258064516129
"8125","7/25/2011",69,2,67,2.98507462686567
"8126","7/25/2012",70,1,69,1.44927536231884
"8127","7/25/2013",77,2,75,2.66666666666667
"8128","7/25/2014",61,2,59,3.38983050847458
"8129","7/25/2015",58,2,56,3.57142857142857
"8130","7/25/2016",71,0,71,0
"8131","7/25/2017",69,5,64,7.8125
"8132","7/25/2018",68,2,66,3.03030303030303
"8133","7/25/2019",71,2,69,2.89855072463768
"8134","7/25/2020",57,4,53,7.54716981132075
"8135","7/25/2021",131,4,127,3.1496062992126
"8136","7/26/1994",75,3,72,4.16666666666667
"8137","7/26/1995",66,0,66,0
"8138","7/26/1996",56,0,56,0
"8139","7/26/1997",66,0,66,0
"8140","7/26/1998",126,4,122,3.27868852459016
"8141","7/26/1999",70,2,68,2.94117647058824
"8142","7/26/2000",74,1,73,1.36986301369863
"8143","7/26/2001",67,3,64,4.6875
"8144","7/26/2002",59,2,57,3.50877192982456
"8145","7/26/2003",68,3,65,4.61538461538462
"8146","7/26/2004",76,3,73,4.10958904109589
"8147","7/26/2005",74,1,73,1.36986301369863
"8148","7/26/2006",71,1,70,1.42857142857143
"8149","7/26/2007",66,1,65,1.53846153846154
"8150","7/26/2008",67,2,65,3.07692307692308
"8151","7/26/2009",155,7,148,4.72972972972973
"8152","7/26/2010",74,0,74,0
"8153","7/26/2011",74,1,73,1.36986301369863
"8154","7/26/2012",75,7,68,10.2941176470588
"8155","7/26/2013",61,5,56,8.92857142857143
"8156","7/26/2014",53,3,50,6
"8157","7/26/2015",135,6,129,4.65116279069767
"8158","7/26/2016",73,2,71,2.8169014084507
"8159","7/26/2017",72,1,71,1.40845070422535
"8160","7/26/2018",76,1,75,1.33333333333333
"8161","7/26/2019",67,6,61,9.83606557377049
"8162","7/26/2020",128,4,124,3.2258064516129
"8163","7/26/2021",77,0,77,0
"8164","7/27/1994",62,0,62,0
"8165","7/27/1995",73,0,73,0
"8166","7/27/1996",53,1,52,1.92307692307692
"8167","7/27/1997",127,1,126,0.793650793650794
"8168","7/27/1998",70,0,70,0
"8169","7/27/1999",73,2,71,2.8169014084507
"8170","7/27/2000",65,2,63,3.17460317460317
"8171","7/27/2001",61,7,54,12.962962962963
"8172","7/27/2002",65,3,62,4.83870967741935
"8173","7/27/2003",123,1,122,0.819672131147541
"8174","7/27/2004",70,1,69,1.44927536231884
"8175","7/27/2005",69,3,66,4.54545454545455
"8176","7/27/2006",70,1,69,1.44927536231884
"8177","7/27/2007",62,4,58,6.89655172413793
"8178","7/27/2008",146,4,142,2.8169014084507
"8179","7/27/2009",70,1,69,1.44927536231884
"8180","7/27/2010",75,1,74,1.35135135135135
"8181","7/27/2011",65,1,64,1.5625
"8182","7/27/2012",47,2,45,4.44444444444444
"8183","7/27/2013",63,5,58,8.62068965517241
"8184","7/27/2014",129,7,122,5.73770491803279
"8185","7/27/2015",75,0,75,0
"8186","7/27/2016",71,0,71,0
"8187","7/27/2017",66,1,65,1.53846153846154
"8188","7/27/2018",64,2,62,3.2258064516129
"8189","7/27/2019",45,0,45,0
"8190","7/27/2020",71,0,71,0
"8191","7/27/2021",69,2,67,2.98507462686567
"8192","7/28/1994",69,2,67,2.98507462686567
"8193","7/28/1995",67,1,66,1.51515151515152
"8194","7/28/1996",129,3,126,2.38095238095238
"8195","7/28/1997",71,3,68,4.41176470588235
"8196","7/28/1998",73,0,73,0
"8197","7/28/1999",74,5,69,7.2463768115942
"8198","7/28/2000",63,5,58,8.62068965517241
"8199","7/28/2001",61,3,58,5.17241379310345
"8200","7/28/2002",130,1,129,0.775193798449612
"8201","7/28/2003",77,0,77,0
"8202","7/28/2004",70,2,68,2.94117647058824
"8203","7/28/2005",72,1,71,1.40845070422535
"8204","7/28/2006",51,1,50,2
"8205","7/28/2007",57,1,56,1.78571428571429
"8206","7/28/2008",76,0,76,0
"8207","7/28/2009",73,1,72,1.38888888888889
"8208","7/28/2010",70,0,70,0
"8209","7/28/2011",70,4,66,6.06060606060606
"8210","7/28/2012",64,3,61,4.91803278688525
"8211","7/28/2013",130,5,125,4
"8212","7/28/2014",67,0,67,0
"8213","7/28/2015",71,1,70,1.42857142857143
"8214","7/28/2016",76,3,73,4.10958904109589
"8215","7/28/2017",67,3,64,4.6875
"8216","7/28/2018",60,2,58,3.44827586206897
"8217","7/28/2019",127,3,124,2.41935483870968
"8218","7/28/2020",71,1,70,1.42857142857143
"8219","7/28/2021",73,3,70,4.28571428571429
"8220","7/29/1994",72,0,72,0
"8221","7/29/1995",65,1,64,1.5625
"8222","7/29/1996",74,0,74,0
"8223","7/29/1997",71,0,71,0
"8224","7/29/1998",68,1,67,1.49253731343284
"8225","7/29/1999",65,2,63,3.17460317460317
"8226","7/29/2000",61,5,56,8.92857142857143
"8227","7/29/2001",129,6,123,4.8780487804878
"8228","7/29/2002",66,0,66,0
"8229","7/29/2003",76,0,76,0
"8230","7/29/2004",68,4,64,6.25
"8231","7/29/2005",67,5,62,8.06451612903226
"8232","7/29/2006",55,5,50,10
"8233","7/29/2007",120,3,117,2.56410256410256
"8234","7/29/2008",74,1,73,1.36986301369863
"8235","7/29/2009",69,1,68,1.47058823529412
"8236","7/29/2010",72,2,70,2.85714285714286
"8237","7/29/2011",66,4,62,6.45161290322581
"8238","7/29/2012",131,6,125,4.8
"8239","7/29/2013",74,1,73,1.36986301369863
"8240","7/29/2014",71,5,66,7.57575757575758
"8241","7/29/2015",75,0,75,0
"8242","7/29/2016",60,4,56,7.14285714285714
"8243","7/29/2017",50,2,48,4.16666666666667
"8244","7/29/2018",123,9,114,7.89473684210526
"8245","7/29/2019",71,0,71,0
"8246","7/29/2020",69,0,69,0
"8247","7/29/2021",64,2,62,3.2258064516129
"8248","7/3/1994",140,2,138,1.44927536231884
"8249","7/3/1995",70,1,69,1.44927536231884
"8250","7/3/1996",72,0,72,0
"8251","7/3/1997",73,1,72,1.38888888888889
"8252","7/3/1998",62,9,53,16.9811320754717
"8253","7/3/1999",61,3,58,5.17241379310345
"8254","7/3/2000",77,1,76,1.31578947368421
"8255","7/3/2001",76,1,75,1.33333333333333
"8256","7/3/2002",77,0,77,0
"8257","7/3/2003",74,3,71,4.22535211267606
"8258","7/3/2004",64,5,59,8.47457627118644
"8259","7/3/2005",125,3,122,2.45901639344262
"8260","7/3/2006",73,1,72,1.38888888888889
"8261","7/3/2007",77,0,77,0
"8262","7/3/2008",72,2,70,2.85714285714286
"8263","7/3/2009",63,4,59,6.77966101694915
"8264","7/3/2010",60,7,53,13.2075471698113
"8265","7/3/2011",127,4,123,3.2520325203252
"8266","7/3/2012",70,1,69,1.44927536231884
"8267","7/3/2013",74,3,71,4.22535211267606
"8268","7/3/2014",74,1,73,1.36986301369863
"8269","7/3/2015",62,4,58,6.89655172413793
"8270","7/3/2016",127,4,123,3.2520325203252
"8271","7/3/2017",77,1,76,1.31578947368421
"8272","7/3/2018",72,2,70,2.85714285714286
"8273","7/3/2019",65,1,64,1.5625
"8274","7/3/2020",64,1,63,1.58730158730159
"8275","7/3/2021",57,5,52,9.61538461538462
"8276","7/30/1994",61,1,60,1.66666666666667
"8277","7/30/1995",120,0,120,0
"8278","7/30/1996",72,1,71,1.40845070422535
"8279","7/30/1997",75,1,74,1.35135135135135
"8280","7/30/1998",68,0,68,0
"8281","7/30/1999",64,6,58,10.3448275862069
"8282","7/30/2000",125,3,122,2.45901639344262
"8283","7/30/2001",74,0,74,0
"8284","7/30/2002",72,1,71,1.40845070422535
"8285","7/30/2003",72,2,70,2.85714285714286
"8286","7/30/2004",55,3,52,5.76923076923077
"8287","7/30/2005",53,4,49,8.16326530612245
"8288","7/30/2006",157,4,153,2.61437908496732
"8289","7/30/2007",72,1,71,1.40845070422535
"8290","7/30/2008",74,0,74,0
"8291","7/30/2009",69,3,66,4.54545454545455
"8292","7/30/2010",52,1,51,1.96078431372549
"8293","7/30/2011",50,3,47,6.38297872340426
"8294","7/30/2012",76,0,76,0
"8295","7/30/2013",74,5,69,7.2463768115942
"8296","7/30/2014",65,3,62,4.83870967741935
"8297","7/30/2015",69,5,64,7.8125
"8298","7/30/2016",62,3,59,5.08474576271187
"8299","7/30/2017",129,8,121,6.61157024793388
"8300","7/30/2018",76,1,75,1.33333333333333
"8301","7/30/2019",70,1,69,1.44927536231884
"8302","7/30/2020",50,2,48,4.16666666666667
"8303","7/30/2021",65,2,63,3.17460317460317
"8304","7/31/1994",125,6,119,5.04201680672269
"8305","7/31/1995",69,0,69,0
"8306","7/31/1996",69,0,69,0
"8307","7/31/1997",72,2,70,2.85714285714286
"8308","7/31/1998",66,3,63,4.76190476190476
"8309","7/31/1999",63,1,62,1.61290322580645
"8310","7/31/2000",74,2,72,2.77777777777778
"8311","7/31/2001",73,1,72,1.38888888888889
"8312","7/31/2002",73,4,69,5.79710144927536
"8313","7/31/2003",64,4,60,6.66666666666667
"8314","7/31/2004",54,2,52,3.84615384615385
"8315","7/31/2005",113,2,111,1.8018018018018
"8316","7/31/2006",69,1,68,1.47058823529412
"8317","7/31/2007",76,1,75,1.33333333333333
"8318","7/31/2008",68,1,67,1.49253731343284
"8319","7/31/2009",64,3,61,4.91803278688525
"8320","7/31/2010",70,6,64,9.375
"8321","7/31/2011",126,8,118,6.77966101694915
"8322","7/31/2012",68,0,68,0
"8323","7/31/2013",69,0,69,0
"8324","7/31/2014",71,2,69,2.89855072463768
"8325","7/31/2015",59,3,56,5.35714285714286
"8326","7/31/2016",132,10,122,8.19672131147541
"8327","7/31/2017",76,0,76,0
"8328","7/31/2018",70,0,70,0
"8329","7/31/2019",68,1,67,1.49253731343284
"8330","7/31/2020",66,5,61,8.19672131147541
"8331","7/31/2021",61,1,60,1.66666666666667
"8332","7/4/1994",69,1,68,1.47058823529412
"8333","7/4/1995",68,1,67,1.49253731343284
"8334","7/4/1996",74,0,74,0
"8335","7/4/1997",66,3,63,4.76190476190476
"8336","7/4/1998",62,2,60,3.33333333333333
"8337","7/4/1999",125,3,122,2.45901639344262
"8338","7/4/2000",72,0,72,0
"8339","7/4/2001",74,3,71,4.22535211267606
"8340","7/4/2002",71,0,71,0
"8341","7/4/2003",62,2,60,3.33333333333333
"8342","7/4/2004",162,7,155,4.51612903225806
"8343","7/4/2005",72,1,71,1.40845070422535
"8344","7/4/2006",75,0,75,0
"8345","7/4/2007",78,4,74,5.40540540540541
"8346","7/4/2008",76,0,76,0
"8347","7/4/2009",67,6,61,9.83606557377049
"8348","7/4/2010",124,6,118,5.08474576271187
"8349","7/4/2011",72,1,71,1.40845070422535
"8350","7/4/2012",74,4,70,5.71428571428571
"8351","7/4/2013",68,3,65,4.61538461538462
"8352","7/4/2014",55,3,52,5.76923076923077
"8353","7/4/2015",57,7,50,14
"8354","7/4/2016",73,1,72,1.38888888888889
"8355","7/4/2017",72,1,71,1.40845070422535
"8356","7/4/2018",72,3,69,4.34782608695652
"8357","7/4/2019",69,2,67,2.98507462686567
"8358","7/4/2020",60,3,57,5.26315789473684
"8359","7/4/2021",126,6,120,5
"8360","7/5/1994",72,2,70,2.85714285714286
"8361","7/5/1995",73,1,72,1.38888888888889
"8362","7/5/1996",61,0,61,0
"8363","7/5/1997",59,2,57,3.50877192982456
"8364","7/5/1998",120,0,120,0
"8365","7/5/1999",76,0,76,0
"8366","7/5/2000",71,1,70,1.42857142857143
"8367","7/5/2001",61,1,60,1.66666666666667
"8368","7/5/2002",66,2,64,3.125
"8369","7/5/2003",60,3,57,5.26315789473684
"8370","7/5/2004",71,1,70,1.42857142857143
"8371","7/5/2005",72,1,71,1.40845070422535
"8372","7/5/2006",68,3,65,4.61538461538462
"8373","7/5/2007",65,2,63,3.17460317460317
"8374","7/5/2008",58,3,55,5.45454545454545
"8375","7/5/2009",130,4,126,3.17460317460317
"8376","7/5/2010",73,1,72,1.38888888888889
"8377","7/5/2011",71,0,71,0
"8378","7/5/2012",64,1,63,1.58730158730159
"8379","7/5/2013",62,3,59,5.08474576271187
"8380","7/5/2014",48,6,42,14.2857142857143
"8381","7/5/2015",123,3,120,2.5
"8382","7/5/2016",72,0,72,0
"8383","7/5/2017",67,3,64,4.6875
"8384","7/5/2018",69,4,65,6.15384615384615
"8385","7/5/2019",65,2,63,3.17460317460317
"8386","7/5/2020",125,4,121,3.30578512396694
"8387","7/5/2021",69,1,68,1.47058823529412
"8388","7/6/1994",72,1,71,1.40845070422535
"8389","7/6/1995",71,3,68,4.41176470588235
"8390","7/6/1996",61,2,59,3.38983050847458
"8391","7/6/1997",126,1,125,0.8
"8392","7/6/1998",75,0,75,0
"8393","7/6/1999",74,3,71,4.22535211267606
"8394","7/6/2000",70,2,68,2.94117647058824
"8395","7/6/2001",63,6,57,10.5263157894737
"8396","7/6/2002",63,1,62,1.61290322580645
"8397","7/6/2003",123,5,118,4.23728813559322
"8398","7/6/2004",72,1,71,1.40845070422535
"8399","7/6/2005",75,2,73,2.73972602739726
"8400","7/6/2006",67,4,63,6.34920634920635
"8401","7/6/2007",61,4,57,7.01754385964912
"8402","7/6/2008",127,6,121,4.95867768595041
"8403","7/6/2009",76,1,75,1.33333333333333
"8404","7/6/2010",77,2,75,2.66666666666667
"8405","7/6/2011",71,2,69,2.89855072463768
"8406","7/6/2012",55,4,51,7.84313725490196
"8407","7/6/2013",66,3,63,4.76190476190476
"8408","7/6/2014",125,9,116,7.75862068965517
"8409","7/6/2015",74,3,71,4.22535211267606
"8410","7/6/2016",72,2,70,2.85714285714286
"8411","7/6/2017",69,0,69,0
"8412","7/6/2018",66,5,61,8.19672131147541
"8413","7/6/2019",56,4,52,7.69230769230769
"8414","7/6/2020",73,8,65,12.3076923076923
"8415","7/6/2021",75,4,71,5.63380281690141
"8416","7/7/1994",71,2,69,2.89855072463768
"8417","7/7/1995",68,1,67,1.49253731343284
"8418","7/7/1996",123,5,118,4.23728813559322
"8419","7/7/1997",75,1,74,1.35135135135135
"8420","7/7/1998",75,3,72,4.16666666666667
"8421","7/7/1999",74,3,71,4.22535211267606
"8422","7/7/2000",65,2,63,3.17460317460317
"8423","7/7/2001",64,4,60,6.66666666666667
"8424","7/7/2002",124,7,117,5.98290598290598
"8425","7/7/2003",73,1,72,1.38888888888889
"8426","7/7/2004",74,1,73,1.36986301369863
"8427","7/7/2005",64,4,60,6.66666666666667
"8428","7/7/2006",72,8,64,12.5
"8429","7/7/2007",65,3,62,4.83870967741935
"8430","7/7/2008",66,1,65,1.53846153846154
"8431","7/7/2009",72,1,71,1.40845070422535
"8432","7/7/2010",75,4,71,5.63380281690141
"8433","7/7/2011",72,5,67,7.46268656716418
"8434","7/7/2012",57,7,50,14
"8435","7/7/2013",125,9,116,7.75862068965517
"8436","7/7/2014",77,2,75,2.66666666666667
"8437","7/7/2015",77,1,76,1.31578947368421
"8438","7/7/2016",69,5,64,7.8125
"8439","7/7/2017",60,3,57,5.26315789473684
"8440","7/7/2018",57,7,50,14
"8441","7/7/2019",133,0,133,0
"8442","7/7/2020",74,0,74,0
"8443","7/7/2021",73,0,73,0
"8444","7/8/1994",55,2,53,3.77358490566038
"8445","7/8/1995",50,0,50,0
"8446","7/8/1996",76,0,76,0
"8447","7/8/1997",75,0,75,0
"8448","7/8/1998",74,3,71,4.22535211267606
"8449","7/8/1999",68,2,66,3.03030303030303
"8450","7/8/2000",52,4,48,8.33333333333333
"8451","7/8/2001",155,9,146,6.16438356164384
"8452","7/8/2002",69,1,68,1.47058823529412
"8453","7/8/2003",76,1,75,1.33333333333333
"8454","7/8/2004",70,3,67,4.47761194029851
"8455","7/8/2005",64,3,61,4.91803278688525
"8456","7/8/2006",67,4,63,6.34920634920635
"8457","7/8/2007",129,6,123,4.8780487804878
"8458","7/8/2008",77,1,76,1.31578947368421
"8459","7/8/2009",69,1,68,1.47058823529412
"8460","7/8/2010",56,1,55,1.81818181818182
"8461","7/8/2011",65,3,62,4.83870967741935
"8462","7/8/2012",124,4,120,3.33333333333333
"8463","7/8/2013",75,0,75,0
"8464","7/8/2014",73,2,71,2.8169014084507
"8465","7/8/2015",66,3,63,4.76190476190476
"8466","7/8/2016",63,5,58,8.62068965517241
"8467","7/8/2017",60,2,58,3.44827586206897
"8468","7/8/2018",130,6,124,4.83870967741935
"8469","7/8/2019",73,0,73,0
"8470","7/8/2020",70,0,70,0
"8471","7/8/2021",75,3,72,4.16666666666667
"8472","7/9/1994",61,1,60,1.66666666666667
"8473","7/9/1995",134,1,133,0.75187969924812
"8474","7/9/1996",73,0,73,0
"8475","7/9/1997",69,0,69,0
"8476","7/9/1998",69,2,67,2.98507462686567
"8477","7/9/1999",69,6,63,9.52380952380952
"8478","7/9/2000",125,3,122,2.45901639344262
"8479","7/9/2001",77,0,77,0
"8480","7/9/2002",72,3,69,4.34782608695652
"8481","7/9/2003",74,0,74,0
"8482","7/9/2004",66,2,64,3.125
"8483","7/9/2005",53,2,51,3.92156862745098
"8484","7/9/2006",119,7,112,6.25
"8485","7/9/2007",75,0,75,0
"8486","7/9/2008",73,4,69,5.79710144927536
"8487","7/9/2009",72,8,64,12.5
"8488","7/9/2010",61,5,56,8.92857142857143
"8489","7/9/2011",67,3,64,4.6875
"8490","7/9/2012",71,0,71,0
"8491","7/9/2013",71,0,71,0
"8492","7/9/2014",71,2,69,2.89855072463768
"8493","7/9/2015",69,5,64,7.8125
"8494","7/9/2016",64,5,59,8.47457627118644
"8495","7/9/2017",129,1,128,0.78125
"8496","7/9/2018",73,3,70,4.28571428571429
"8497","7/9/2019",75,0,75,0
"8498","7/9/2020",72,4,68,5.88235294117647
"8499","7/9/2021",65,6,59,10.1694915254237
"8500","8/1/1994",71,1,70,1.42857142857143
"8501","8/1/1995",69,0,69,0
"8502","8/1/1996",65,1,64,1.5625
"8503","8/1/1997",56,5,51,9.80392156862745
"8504","8/1/1998",57,0,57,0
"8505","8/1/1999",124,3,121,2.47933884297521
"8506","8/1/2000",76,2,74,2.7027027027027
"8507","8/1/2001",75,1,74,1.35135135135135
"8508","8/1/2002",66,2,64,3.125
"8509","8/1/2003",56,4,52,7.69230769230769
"8510","8/1/2004",125,2,123,1.6260162601626
"8511","8/1/2005",77,1,76,1.31578947368421
"8512","8/1/2006",70,1,69,1.44927536231884
"8513","8/1/2007",75,4,71,5.63380281690141
"8514","8/1/2008",56,4,52,7.69230769230769
"8515","8/1/2009",56,2,54,3.7037037037037
"8516","8/1/2010",125,3,122,2.45901639344262
"8517","8/1/2011",72,1,71,1.40845070422535
"8518","8/1/2012",69,2,67,2.98507462686567
"8519","8/1/2013",70,2,68,2.94117647058824
"8520","8/1/2014",62,4,58,6.89655172413793
"8521","8/1/2015",58,3,55,5.45454545454545
"8522","8/1/2016",71,1,70,1.42857142857143
"8523","8/1/2017",75,3,72,4.16666666666667
"8524","8/1/2018",72,0,72,0
"8525","8/1/2019",75,4,71,5.63380281690141
"8526","8/1/2020",65,4,61,6.55737704918033
"8527","8/1/2021",124,9,115,7.82608695652174
"8528","8/10/1994",71,1,70,1.42857142857143
"8529","8/10/1995",73,0,73,0
"8530","8/10/1996",60,3,57,5.26315789473684
"8531","8/10/1997",155,2,153,1.30718954248366
"8532","8/10/1998",70,1,69,1.44927536231884
"8533","8/10/1999",70,3,67,4.47761194029851
"8534","8/10/2000",60,0,60,0
"8535","8/10/2001",59,4,55,7.27272727272727
"8536","8/10/2002",66,1,65,1.53846153846154
"8537","8/10/2003",124,3,121,2.47933884297521
"8538","8/10/2004",73,2,71,2.8169014084507
"8539","8/10/2005",71,5,66,7.57575757575758
"8540","8/10/2006",70,5,65,7.69230769230769
"8541","8/10/2007",55,1,54,1.85185185185185
"8542","8/10/2008",127,7,120,5.83333333333333
"8543","8/10/2009",73,1,72,1.38888888888889
"8544","8/10/2010",75,4,71,5.63380281690141
"8545","8/10/2011",72,3,69,4.34782608695652
"8546","8/10/2012",66,4,62,6.45161290322581
"8547","8/10/2013",61,8,53,15.0943396226415
"8548","8/10/2014",126,9,117,7.69230769230769
"8549","8/10/2015",76,0,76,0
"8550","8/10/2016",75,1,74,1.35135135135135
"8551","8/10/2017",70,2,68,2.94117647058824
"8552","8/10/2018",64,0,64,0
"8553","8/10/2019",58,4,54,7.40740740740741
"8554","8/10/2020",72,0,72,0
"8555","8/10/2021",70,1,69,1.44927536231884
"8556","8/11/1994",72,2,70,2.85714285714286
"8557","8/11/1995",58,3,55,5.45454545454545
"8558","8/11/1996",145,0,145,0
"8559","8/11/1997",75,1,74,1.35135135135135
"8560","8/11/1998",73,1,72,1.38888888888889
"8561","8/11/1999",69,1,68,1.47058823529412
"8562","8/11/2000",63,5,58,8.62068965517241
"8563","8/11/2001",59,3,56,5.35714285714286
"8564","8/11/2002",131,2,129,1.55038759689922
"8565","8/11/2003",75,0,75,0
"8566","8/11/2004",75,6,69,8.69565217391304
"8567","8/11/2005",66,1,65,1.53846153846154
"8568","8/11/2006",63,3,60,5
"8569","8/11/2007",61,2,59,3.38983050847458
"8570","8/11/2008",73,0,73,0
"8571","8/11/2009",72,1,71,1.40845070422535
"8572","8/11/2010",70,0,70,0
"8573","8/11/2011",71,8,63,12.6984126984127
"8574","8/11/2012",63,3,60,5
"8575","8/11/2013",127,10,117,8.54700854700855
"8576","8/11/2014",69,0,69,0
"8577","8/11/2015",73,3,70,4.28571428571429
"8578","8/11/2016",69,8,61,13.1147540983607
"8579","8/11/2017",70,4,66,6.06060606060606
"8580","8/11/2018",52,3,49,6.12244897959184
"8581","8/11/2019",132,3,129,2.32558139534884
"8582","8/11/2020",71,2,69,2.89855072463768
"8583","8/11/2021",58,1,57,1.75438596491228
"8584","8/12/1994",69,1,68,1.47058823529412
"8585","8/12/1995",61,2,59,3.38983050847458
"8586","8/12/1996",76,0,76,0
"8587","8/12/1997",74,0,74,0
"8588","8/12/1998",73,1,72,1.38888888888889
"8589","8/12/1999",62,1,61,1.63934426229508
"8590","8/12/2000",60,0,60,0
"8591","8/12/2001",129,3,126,2.38095238095238
"8592","8/12/2002",74,3,71,4.22535211267606
"8593","8/12/2003",76,1,75,1.33333333333333
"8594","8/12/2004",65,2,63,3.17460317460317
"8595","8/12/2005",53,2,51,3.92156862745098
"8596","8/12/2006",57,4,53,7.54716981132075
"8597","8/12/2007",128,4,124,3.2258064516129
"8598","8/12/2008",72,0,72,0
"8599","8/12/2009",65,2,63,3.17460317460317
"8600","8/12/2010",74,2,72,2.77777777777778
"8601","8/12/2011",50,1,49,2.04081632653061
"8602","8/12/2012",127,6,121,4.95867768595041
"8603","8/12/2013",73,1,72,1.38888888888889
"8604","8/12/2014",75,2,73,2.73972602739726
"8605","8/12/2015",69,2,67,2.98507462686567
"8606","8/12/2016",70,3,67,4.47761194029851
"8607","8/12/2017",53,3,50,6
"8608","8/12/2018",125,4,121,3.30578512396694
"8609","8/12/2019",71,1,70,1.42857142857143
"8610","8/12/2020",75,1,74,1.35135135135135
"8611","8/12/2021",70,4,66,6.06060606060606
"8612","8/13/1994",64,1,63,1.58730158730159
"8613","8/13/1995",123,3,120,2.5
"8614","8/13/1996",71,1,70,1.42857142857143
"8615","8/13/1997",76,0,76,0
"8616","8/13/1998",68,2,66,3.03030303030303
"8617","8/13/1999",75,3,72,4.16666666666667
"8618","8/13/2000",128,5,123,4.0650406504065
"8619","8/13/2001",75,0,75,0
"8620","8/13/2002",76,0,76,0
"8621","8/13/2003",70,1,69,1.44927536231884
"8622","8/13/2004",69,3,66,4.54545454545455
"8623","8/13/2005",62,0,62,0
"8624","8/13/2006",122,3,119,2.52100840336134
"8625","8/13/2007",73,0,73,0
"8626","8/13/2008",65,1,64,1.5625
"8627","8/13/2009",68,1,67,1.49253731343284
"8628","8/13/2010",55,5,50,10
"8629","8/13/2011",65,11,54,20.3703703703704
"8630","8/13/2012",76,0,76,0
"8631","8/13/2013",70,2,68,2.94117647058824
"8632","8/13/2014",75,2,73,2.73972602739726
"8633","8/13/2015",68,0,68,0
"8634","8/13/2016",61,3,58,5.17241379310345
"8635","8/13/2017",131,1,130,0.769230769230769
"8636","8/13/2018",74,1,73,1.36986301369863
"8637","8/13/2019",76,1,75,1.33333333333333
"8638","8/13/2020",69,3,66,4.54545454545455
"8639","8/13/2021",65,5,60,8.33333333333333
"8640","8/14/1994",157,6,151,3.97350993377483
"8641","8/14/1995",71,1,70,1.42857142857143
"8642","8/14/1996",73,0,73,0
"8643","8/14/1997",64,0,64,0
"8644","8/14/1998",57,1,56,1.78571428571429
"8645","8/14/1999",63,1,62,1.61290322580645
"8646","8/14/2000",74,0,74,0
"8647","8/14/2001",75,2,73,2.73972602739726
"8648","8/14/2002",74,2,72,2.77777777777778
"8649","8/14/2003",74,2,72,2.77777777777778
"8650","8/14/2004",58,2,56,3.57142857142857
"8651","8/14/2005",128,2,126,1.58730158730159
"8652","8/14/2006",73,1,72,1.38888888888889
"8653","8/14/2007",74,0,74,0
"8654","8/14/2008",69,1,68,1.47058823529412
"8655","8/14/2009",64,4,60,6.66666666666667
"8656","8/14/2010",58,4,54,7.40740740740741
"8657","8/14/2011",128,4,124,3.2258064516129
"8658","8/14/2012",70,0,70,0
"8659","8/14/2013",69,2,67,2.98507462686567
"8660","8/14/2014",64,3,61,4.91803278688525
"8661","8/14/2015",63,4,59,6.77966101694915
"8662","8/14/2016",130,8,122,6.55737704918033
"8663","8/14/2017",70,1,69,1.44927536231884
"8664","8/14/2018",71,4,67,5.97014925373134
"8665","8/14/2019",75,3,72,4.16666666666667
"8666","8/14/2020",64,3,61,4.91803278688525
"8667","8/14/2021",56,3,53,5.66037735849057
"8668","8/15/1994",74,1,73,1.36986301369863
"8669","8/15/1995",74,0,74,0
"8670","8/15/1996",67,1,66,1.51515151515152
"8671","8/15/1997",64,3,61,4.91803278688525
"8672","8/15/1998",68,3,65,4.61538461538462
"8673","8/15/1999",121,4,117,3.41880341880342
"8674","8/15/2000",72,1,71,1.40845070422535
"8675","8/15/2001",69,1,68,1.47058823529412
"8676","8/15/2002",68,0,68,0
"8677","8/15/2003",58,2,56,3.57142857142857
"8678","8/15/2004",153,3,150,2
"8679","8/15/2005",75,0,75,0
"8680","8/15/2006",73,0,73,0
"8681","8/15/2007",73,1,72,1.38888888888889
"8682","8/15/2008",68,1,67,1.49253731343284
"8683","8/15/2009",61,7,54,12.962962962963
"8684","8/15/2010",127,8,119,6.72268907563025
"8685","8/15/2011",69,0,69,0
"8686","8/15/2012",71,3,68,4.41176470588235
"8687","8/15/2013",68,1,67,1.49253731343284
"8688","8/15/2014",64,7,57,12.280701754386
"8689","8/15/2015",57,2,55,3.63636363636364
"8690","8/15/2016",74,2,72,2.77777777777778
"8691","8/15/2017",74,4,70,5.71428571428571
"8692","8/15/2018",73,1,72,1.38888888888889
"8693","8/15/2019",64,2,62,3.2258064516129
"8694","8/15/2020",58,2,56,3.57142857142857
"8695","8/15/2021",135,7,128,5.46875
"8696","8/16/1994",75,0,75,0
"8697","8/16/1995",64,4,60,6.66666666666667
"8698","8/16/1996",61,0,61,0
"8699","8/16/1997",59,4,55,7.27272727272727
"8700","8/16/1998",128,5,123,4.0650406504065
"8701","8/16/1999",71,3,68,4.41176470588235
"8702","8/16/2000",71,0,71,0
"8703","8/16/2001",71,5,66,7.57575757575758
"8704","8/16/2002",64,1,63,1.58730158730159
"8705","8/16/2003",63,5,58,8.62068965517241
"8706","8/16/2004",76,0,76,0
"8707","8/16/2005",75,2,73,2.73972602739726
"8708","8/16/2006",75,4,71,5.63380281690141
"8709","8/16/2007",70,0,70,0
"8710","8/16/2008",52,4,48,8.33333333333333
"8711","8/16/2009",124,2,122,1.63934426229508
"8712","8/16/2010",74,1,73,1.36986301369863
"8713","8/16/2011",75,2,73,2.73972602739726
"8714","8/16/2012",63,2,61,3.27868852459016
"8715","8/16/2013",68,8,60,13.3333333333333
"8716","8/16/2014",60,6,54,11.1111111111111
"8717","8/16/2015",122,3,119,2.52100840336134
"8718","8/16/2016",75,0,75,0
"8719","8/16/2017",70,3,67,4.47761194029851
"8720","8/16/2018",70,1,69,1.44927536231884
"8721","8/16/2019",67,3,64,4.6875
"8722","8/16/2020",129,7,122,5.73770491803279
"8723","8/16/2021",73,2,71,2.8169014084507
"8724","8/17/1994",65,2,63,3.17460317460317
"8725","8/17/1995",70,0,70,0
"8726","8/17/1996",57,1,56,1.78571428571429
"8727","8/17/1997",127,4,123,3.2520325203252
"8728","8/17/1998",76,0,76,0
"8729","8/17/1999",74,0,74,0
"8730","8/17/2000",67,2,65,3.07692307692308
"8731","8/17/2001",61,7,54,12.962962962963
"8732","8/17/2002",58,2,56,3.57142857142857
"8733","8/17/2003",118,8,110,7.27272727272727
"8734","8/17/2004",73,0,73,0
"8735","8/17/2005",71,3,68,4.41176470588235
"8736","8/17/2006",72,3,69,4.34782608695652
"8737","8/17/2007",58,4,54,7.40740740740741
"8738","8/17/2008",130,6,124,4.83870967741935
"8739","8/17/2009",76,1,75,1.33333333333333
"8740","8/17/2010",66,0,66,0
"8741","8/17/2011",72,2,70,2.85714285714286
"8742","8/17/2012",60,2,58,3.44827586206897
"8743","8/17/2013",61,7,54,12.962962962963
"8744","8/17/2014",120,11,109,10.0917431192661
"8745","8/17/2015",74,1,73,1.36986301369863
"8746","8/17/2016",73,1,72,1.38888888888889
"8747","8/17/2017",71,3,68,4.41176470588235
"8748","8/17/2018",59,2,57,3.50877192982456
"8749","8/17/2019",63,4,59,6.77966101694915
"8750","8/17/2020",69,0,69,0
"8751","8/17/2021",71,3,68,4.41176470588235
"8752","8/18/1994",69,0,69,0
"8753","8/18/1995",61,1,60,1.66666666666667
"8754","8/18/1996",131,0,131,0
"8755","8/18/1997",74,2,72,2.77777777777778
"8756","8/18/1998",77,3,74,4.05405405405405
"8757","8/18/1999",71,2,69,2.89855072463768
"8758","8/18/2000",55,1,54,1.85185185185185
"8759","8/18/2001",67,5,62,8.06451612903226
"8760","8/18/2002",123,1,122,0.819672131147541
"8761","8/18/2003",77,0,77,0
"8762","8/18/2004",71,0,71,0
"8763","8/18/2005",75,0,75,0
"8764","8/18/2006",63,4,59,6.77966101694915
"8765","8/18/2007",52,4,48,8.33333333333333
"8766","8/18/2008",72,2,70,2.85714285714286
"8767","8/18/2009",77,2,75,2.66666666666667
"8768","8/18/2010",70,0,70,0
"8769","8/18/2011",81,2,79,2.53164556962025
"8770","8/18/2012",66,6,60,10
"8771","8/18/2013",120,9,111,8.10810810810811
"8772","8/18/2014",66,1,65,1.53846153846154
"8773","8/18/2015",70,1,69,1.44927536231884
"8774","8/18/2016",63,2,61,3.27868852459016
"8775","8/18/2017",62,1,61,1.63934426229508
"8776","8/18/2018",58,1,57,1.75438596491228
"8777","8/18/2019",131,6,125,4.8
"8778","8/18/2020",68,0,68,0
"8779","8/18/2021",72,1,71,1.40845070422535
"8780","8/19/1994",66,4,62,6.45161290322581
"8781","8/19/1995",58,3,55,5.45454545454545
"8782","8/19/1996",75,0,75,0
"8783","8/19/1997",71,2,69,2.89855072463768
"8784","8/19/1998",72,0,72,0
"8785","8/19/1999",70,2,68,2.94117647058824
"8786","8/19/2000",63,3,60,5
"8787","8/19/2001",120,6,114,5.26315789473684
"8788","8/19/2002",74,1,73,1.36986301369863
"8789","8/19/2003",70,3,67,4.47761194029851
"8790","8/19/2004",67,0,67,0
"8791","8/19/2005",68,2,66,3.03030303030303
"8792","8/19/2006",64,1,63,1.58730158730159
"8793","8/19/2007",134,3,131,2.29007633587786
"8794","8/19/2008",72,1,71,1.40845070422535
"8795","8/19/2009",72,3,69,4.34782608695652
"8796","8/19/2010",65,2,63,3.17460317460317
"8797","8/19/2011",53,4,49,8.16326530612245
"8798","8/19/2012",125,5,120,4.16666666666667
"8799","8/19/2013",72,1,71,1.40845070422535
"8800","8/19/2014",68,1,67,1.49253731343284
"8801","8/19/2015",74,1,73,1.36986301369863
"8802","8/19/2016",70,5,65,7.69230769230769
"8803","8/19/2017",47,5,42,11.9047619047619
"8804","8/19/2018",128,5,123,4.0650406504065
"8805","8/19/2019",81,0,81,0
"8806","8/19/2020",72,4,68,5.88235294117647
"8807","8/19/2021",74,4,70,5.71428571428571
"8808","8/2/1994",71,1,70,1.42857142857143
"8809","8/2/1995",72,0,72,0
"8810","8/2/1996",66,1,65,1.53846153846154
"8811","8/2/1997",67,0,67,0
"8812","8/2/1998",128,2,126,1.58730158730159
"8813","8/2/1999",70,0,70,0
"8814","8/2/2000",71,1,70,1.42857142857143
"8815","8/2/2001",71,2,69,2.89855072463768
"8816","8/2/2002",63,3,60,5
"8817","8/2/2003",64,3,61,4.91803278688525
"8818","8/2/2004",75,3,72,4.16666666666667
"8819","8/2/2005",73,0,73,0
"8820","8/2/2006",70,1,69,1.44927536231884
"8821","8/2/2007",68,2,66,3.03030303030303
"8822","8/2/2008",60,2,58,3.44827586206897
"8823","8/2/2009",120,1,119,0.840336134453782
"8824","8/2/2010",73,0,73,0
"8825","8/2/2011",70,1,69,1.44927536231884
"8826","8/2/2012",62,4,58,6.89655172413793
"8827","8/2/2013",62,6,56,10.7142857142857
"8828","8/2/2014",66,3,63,4.76190476190476
"8829","8/2/2015",126,3,123,2.4390243902439
"8830","8/2/2016",72,6,66,9.09090909090909
"8831","8/2/2017",73,2,71,2.8169014084507
"8832","8/2/2018",77,7,70,10
"8833","8/2/2019",66,5,61,8.19672131147541
"8834","8/2/2020",125,5,120,4.16666666666667
"8835","8/2/2021",71,1,70,1.42857142857143
"8836","8/20/1994",63,0,63,0
"8837","8/20/1995",132,5,127,3.93700787401575
"8838","8/20/1996",75,1,74,1.35135135135135
"8839","8/20/1997",72,2,70,2.85714285714286
"8840","8/20/1998",68,0,68,0
"8841","8/20/1999",61,2,59,3.38983050847458
"8842","8/20/2000",148,2,146,1.36986301369863
"8843","8/20/2001",73,2,71,2.8169014084507
"8844","8/20/2002",70,1,69,1.44927536231884
"8845","8/20/2003",70,1,69,1.44927536231884
"8846","8/20/2004",65,1,64,1.5625
"8847","8/20/2005",56,3,53,5.66037735849057
"8848","8/20/2006",128,5,123,4.0650406504065
"8849","8/20/2007",70,0,70,0
"8850","8/20/2008",74,0,74,0
"8851","8/20/2009",65,5,60,8.33333333333333
"8852","8/20/2010",61,2,59,3.38983050847458
"8853","8/20/2011",50,8,42,19.047619047619
"8854","8/20/2012",69,0,69,0
"8855","8/20/2013",69,2,67,2.98507462686567
"8856","8/20/2014",74,3,71,4.22535211267606
"8857","8/20/2015",78,5,73,6.84931506849315
"8858","8/20/2016",57,5,52,9.61538461538462
"8859","8/20/2017",127,7,120,5.83333333333333
"8860","8/20/2018",73,2,71,2.8169014084507
"8861","8/20/2019",72,0,72,0
"8862","8/20/2020",63,1,62,1.61290322580645
"8863","8/20/2021",57,2,55,3.63636363636364
"8864","8/21/1994",124,2,122,1.63934426229508
"8865","8/21/1995",75,1,74,1.35135135135135
"8866","8/21/1996",74,0,74,0
"8867","8/21/1997",70,4,66,6.06060606060606
"8868","8/21/1998",61,3,58,5.17241379310345
"8869","8/21/1999",60,1,59,1.69491525423729
"8870","8/21/2000",73,3,70,4.28571428571429
"8871","8/21/2001",77,3,74,4.05405405405405
"8872","8/21/2002",69,0,69,0
"8873","8/21/2003",77,2,75,2.66666666666667
"8874","8/21/2004",58,2,56,3.57142857142857
"8875","8/21/2005",117,6,111,5.40540540540541
"8876","8/21/2006",74,0,74,0
"8877","8/21/2007",76,0,76,0
"8878","8/21/2008",67,2,65,3.07692307692308
"8879","8/21/2009",60,4,56,7.14285714285714
"8880","8/21/2010",67,3,64,4.6875
"8881","8/21/2011",125,6,119,5.04201680672269
"8882","8/21/2012",70,1,69,1.44927536231884
"8883","8/21/2013",72,2,70,2.85714285714286
"8884","8/21/2014",70,5,65,7.69230769230769
"8885","8/21/2015",60,7,53,13.2075471698113
"8886","8/21/2016",127,5,122,4.0983606557377
"8887","8/21/2017",77,1,76,1.31578947368421
"8888","8/21/2018",72,2,70,2.85714285714286
"8889","8/21/2019",71,6,65,9.23076923076923
"8890","8/21/2020",67,3,64,4.6875
"8891","8/21/2021",62,6,56,10.7142857142857
"8892","8/22/1994",76,1,75,1.33333333333333
"8893","8/22/1995",76,0,76,0
"8894","8/22/1996",67,1,66,1.51515151515152
"8895","8/22/1997",49,1,48,2.08333333333333
"8896","8/22/1998",61,1,60,1.66666666666667
"8897","8/22/1999",126,1,125,0.8
"8898","8/22/2000",73,1,72,1.38888888888889
"8899","8/22/2001",72,4,68,5.88235294117647
"8900","8/22/2002",68,1,67,1.49253731343284
"8901","8/22/2003",62,5,57,8.7719298245614
"8902","8/22/2004",129,2,127,1.5748031496063
"8903","8/22/2005",78,0,78,0
"8904","8/22/2006",74,0,74,0
"8905","8/22/2007",69,1,68,1.47058823529412
"8906","8/22/2008",48,2,46,4.34782608695652
"8907","8/22/2009",64,5,59,8.47457627118644
"8908","8/22/2010",126,6,120,5
"8909","8/22/2011",73,1,72,1.38888888888889
"8910","8/22/2012",74,1,73,1.36986301369863
"8911","8/22/2013",73,1,72,1.38888888888889
"8912","8/22/2014",62,4,58,6.89655172413793
"8913","8/22/2015",61,3,58,5.17241379310345
"8914","8/22/2016",69,0,69,0
"8915","8/22/2017",72,2,70,2.85714285714286
"8916","8/22/2018",70,0,70,0
"8917","8/22/2019",77,4,73,5.47945205479452
"8918","8/22/2020",63,4,59,6.77966101694915
"8919","8/22/2021",135,8,127,6.2992125984252
"8920","8/23/1994",74,0,74,0
"8921","8/23/1995",72,0,72,0
"8922","8/23/1996",62,3,59,5.08474576271187
"8923","8/23/1997",64,1,63,1.58730158730159
"8924","8/23/1998",125,0,125,0
"8925","8/23/1999",74,0,74,0
"8926","8/23/2000",71,4,67,5.97014925373134
"8927","8/23/2001",69,5,64,7.8125
"8928","8/23/2002",60,3,57,5.26315789473684
"8929","8/23/2003",57,3,54,5.55555555555556
"8930","8/23/2004",73,1,72,1.38888888888889
"8931","8/23/2005",70,1,69,1.44927536231884
"8932","8/23/2006",74,1,73,1.36986301369863
"8933","8/23/2007",65,0,65,0
"8934","8/23/2008",61,7,54,12.962962962963
"8935","8/23/2009",134,3,131,2.29007633587786
"8936","8/23/2010",73,1,72,1.38888888888889
"8937","8/23/2011",71,1,70,1.42857142857143
"8938","8/23/2012",78,2,76,2.63157894736842
"8939","8/23/2013",59,7,52,13.4615384615385
"8940","8/23/2014",71,6,65,9.23076923076923
"8941","8/23/2015",123,7,116,6.03448275862069
"8942","8/23/2016",71,3,68,4.41176470588235
"8943","8/23/2017",70,3,67,4.47761194029851
"8944","8/23/2018",65,3,62,4.83870967741935
"8945","8/23/2019",64,2,62,3.2258064516129
"8946","8/23/2020",133,5,128,3.90625
"8947","8/23/2021",78,0,78,0
"8948","8/24/1994",75,4,71,5.63380281690141
"8949","8/24/1995",69,0,69,0
"8950","8/24/1996",67,3,64,4.6875
"8951","8/24/1997",130,5,125,4
"8952","8/24/1998",71,0,71,0
"8953","8/24/1999",75,0,75,0
"8954","8/24/2000",66,2,64,3.125
"8955","8/24/2001",64,4,60,6.66666666666667
"8956","8/24/2002",56,2,54,3.7037037037037
"8957","8/24/2003",119,1,118,0.847457627118644
"8958","8/24/2004",71,2,69,2.89855072463768
"8959","8/24/2005",74,0,74,0
"8960","8/24/2006",68,4,64,6.25
"8961","8/24/2007",61,2,59,3.38983050847458
"8962","8/24/2008",140,2,138,1.44927536231884
"8963","8/24/2009",72,1,71,1.40845070422535
"8964","8/24/2010",69,0,69,0
"8965","8/24/2011",69,0,69,0
"8966","8/24/2012",54,1,53,1.88679245283019
"8967","8/24/2013",68,7,61,11.4754098360656
"8968","8/24/2014",124,11,113,9.73451327433628
"8969","8/24/2015",70,0,70,0
"8970","8/24/2016",70,0,70,0
"8971","8/24/2017",76,4,72,5.55555555555556
"8972","8/24/2018",62,4,58,6.89655172413793
"8973","8/24/2019",58,7,51,13.7254901960784
"8974","8/24/2020",76,4,72,5.55555555555556
"8975","8/24/2021",73,3,70,4.28571428571429
"8976","8/25/1994",68,1,67,1.49253731343284
"8977","8/25/1995",64,1,63,1.58730158730159
"8978","8/25/1996",127,3,124,2.41935483870968
"8979","8/25/1997",73,0,73,0
"8980","8/25/1998",76,1,75,1.33333333333333
"8981","8/25/1999",74,2,72,2.77777777777778
"8982","8/25/2000",66,4,62,6.45161290322581
"8983","8/25/2001",52,2,50,4
"8984","8/25/2002",125,2,123,1.6260162601626
"8985","8/25/2003",72,2,70,2.85714285714286
"8986","8/25/2004",74,3,71,4.22535211267606
"8987","8/25/2005",67,2,65,3.07692307692308
"8988","8/25/2006",62,3,59,5.08474576271187
"8989","8/25/2007",60,3,57,5.26315789473684
"8990","8/25/2008",74,0,74,0
"8991","8/25/2009",72,0,72,0
"8992","8/25/2010",75,0,75,0
"8993","8/25/2011",75,2,73,2.73972602739726
"8994","8/25/2012",68,3,65,4.61538461538462
"8995","8/25/2013",122,2,120,1.66666666666667
"8996","8/25/2014",73,1,72,1.38888888888889
"8997","8/25/2015",72,1,71,1.40845070422535
"8998","8/25/2016",67,5,62,8.06451612903226
"8999","8/25/2017",65,4,61,6.55737704918033
"9000","8/25/2018",58,3,55,5.45454545454545
"9001","8/25/2019",128,4,124,3.2258064516129
"9002","8/25/2020",76,4,72,5.55555555555556
"9003","8/25/2021",74,3,71,4.22535211267606
"9004","8/26/1994",71,1,70,1.42857142857143
"9005","8/26/1995",58,0,58,0
"9006","8/26/1996",74,0,74,0
"9007","8/26/1997",73,0,73,0
"9008","8/26/1998",70,2,68,2.94117647058824
"9009","8/26/1999",73,0,73,0
"9010","8/26/2000",63,4,59,6.77966101694915
"9011","8/26/2001",130,8,122,6.55737704918033
"9012","8/26/2002",73,0,73,0
"9013","8/26/2003",76,3,73,4.10958904109589
"9014","8/26/2004",67,1,66,1.51515151515152
"9015","8/26/2005",63,1,62,1.61290322580645
"9016","8/26/2006",66,5,61,8.19672131147541
"9017","8/26/2007",124,3,121,2.47933884297521
"9018","8/26/2008",71,1,70,1.42857142857143
"9019","8/26/2009",70,0,70,0
"9020","8/26/2010",70,2,68,2.94117647058824
"9021","8/26/2011",55,6,49,12.2448979591837
"9022","8/26/2012",126,9,117,7.69230769230769
"9023","8/26/2013",77,2,75,2.66666666666667
"9024","8/26/2014",71,2,69,2.89855072463768
"9025","8/26/2015",67,3,64,4.6875
"9026","8/26/2016",65,6,59,10.1694915254237
"9027","8/26/2017",64,3,61,4.91803278688525
"9028","8/26/2018",130,7,123,5.69105691056911
"9029","8/26/2019",77,1,76,1.31578947368421
"9030","8/26/2020",68,3,65,4.61538461538462
"9031","8/26/2021",82,2,80,2.5
"9032","8/27/1994",72,1,71,1.40845070422535
"9033","8/27/1995",105,4,101,3.96039603960396
"9034","8/27/1996",70,1,69,1.44927536231884
"9035","8/27/1997",70,0,70,0
"9036","8/27/1998",69,3,66,4.54545454545455
"9037","8/27/1999",65,5,60,8.33333333333333
"9038","8/27/2000",121,10,111,9.00900900900901
"9039","8/27/2001",73,0,73,0
"9040","8/27/2002",74,1,73,1.36986301369863
"9041","8/27/2003",72,2,70,2.85714285714286
"9042","8/27/2004",50,3,47,6.38297872340426
"9043","8/27/2005",51,1,50,2
"9044","8/27/2006",133,6,127,4.7244094488189
"9045","8/27/2007",75,0,75,0
"9046","8/27/2008",67,3,64,4.6875
"9047","8/27/2009",72,2,70,2.85714285714286
"9048","8/27/2010",63,4,59,6.77966101694915
"9049","8/27/2011",65,6,59,10.1694915254237
"9050","8/27/2012",73,0,73,0
"9051","8/27/2013",74,0,74,0
"9052","8/27/2014",71,3,68,4.41176470588235
"9053","8/27/2015",71,4,67,5.97014925373134
"9054","8/27/2016",69,4,65,6.15384615384615
"9055","8/27/2017",132,12,120,10
"9056","8/27/2018",75,0,75,0
"9057","8/27/2019",70,1,69,1.44927536231884
"9058","8/27/2020",70,6,64,9.375
"9059","8/27/2021",65,4,61,6.55737704918033
"9060","8/28/1994",113,1,112,0.892857142857143
"9061","8/28/1995",75,1,74,1.35135135135135
"9062","8/28/1996",66,1,65,1.53846153846154
"9063","8/28/1997",68,0,68,0
"9064","8/28/1998",59,4,55,7.27272727272727
"9065","8/28/1999",58,1,57,1.75438596491228
"9066","8/28/2000",75,3,72,4.16666666666667
"9067","8/28/2001",73,1,72,1.38888888888889
"9068","8/28/2002",73,2,71,2.8169014084507
"9069","8/28/2003",69,1,68,1.47058823529412
"9070","8/28/2004",64,5,59,8.47457627118644
"9071","8/28/2005",162,4,158,2.53164556962025
"9072","8/28/2006",74,0,74,0
"9073","8/28/2007",69,0,69,0
"9074","8/28/2008",71,2,69,2.89855072463768
"9075","8/28/2009",64,6,58,10.3448275862069
"9076","8/28/2010",64,6,58,10.3448275862069
"9077","8/28/2011",121,4,117,3.41880341880342
"9078","8/28/2012",75,2,73,2.73972602739726
"9079","8/28/2013",69,7,62,11.2903225806452
"9080","8/28/2014",64,2,62,3.2258064516129
"9081","8/28/2015",65,4,61,6.55737704918033
"9082","8/28/2016",123,9,114,7.89473684210526
"9083","8/28/2017",75,3,72,4.16666666666667
"9084","8/28/2018",71,1,70,1.42857142857143
"9085","8/28/2019",71,5,66,7.57575757575758
"9086","8/28/2020",67,3,64,4.6875
"9087","8/28/2021",63,3,60,5
"9088","8/29/1994",73,2,71,2.8169014084507
"9089","8/29/1995",67,1,66,1.51515151515152
"9090","8/29/1996",64,2,62,3.2258064516129
"9091","8/29/1997",66,3,63,4.76190476190476
"9092","8/29/1998",59,2,57,3.50877192982456
"9093","8/29/1999",131,3,128,2.34375
"9094","8/29/2000",71,1,70,1.42857142857143
"9095","8/29/2001",65,0,65,0
"9096","8/29/2002",66,1,65,1.53846153846154
"9097","8/29/2003",60,3,57,5.26315789473684
"9098","8/29/2004",127,2,125,1.6
"9099","8/29/2005",67,2,65,3.07692307692308
"9100","8/29/2006",70,1,69,1.44927536231884
"9101","8/29/2007",72,1,71,1.40845070422535
"9102","8/29/2008",58,5,53,9.43396226415094
"9103","8/29/2009",59,2,57,3.50877192982456
"9104","8/29/2010",117,0,117,0
"9105","8/29/2011",72,0,72,0
"9106","8/29/2012",70,1,69,1.44927536231884
"9107","8/29/2013",65,6,59,10.1694915254237
"9108","8/29/2014",64,6,58,10.3448275862069
"9109","8/29/2015",65,8,57,14.0350877192982
"9110","8/29/2016",76,2,74,2.7027027027027
"9111","8/29/2017",70,2,68,2.94117647058824
"9112","8/29/2018",69,4,65,6.15384615384615
"9113","8/29/2019",71,4,67,5.97014925373134
"9114","8/29/2020",63,2,61,3.27868852459016
"9115","8/29/2021",129,6,123,4.8780487804878
"9116","8/3/1994",68,0,68,0
"9117","8/3/1995",71,0,71,0
"9118","8/3/1996",62,0,62,0
"9119","8/3/1997",125,2,123,1.6260162601626
"9120","8/3/1998",70,1,69,1.44927536231884
"9121","8/3/1999",72,2,70,2.85714285714286
"9122","8/3/2000",68,1,67,1.49253731343284
"9123","8/3/2001",66,8,58,13.7931034482759
"9124","8/3/2002",53,3,50,6
"9125","8/3/2003",121,4,117,3.41880341880342
"9126","8/3/2004",73,1,72,1.38888888888889
"9127","8/3/2005",73,0,73,0
"9128","8/3/2006",74,1,73,1.36986301369863
"9129","8/3/2007",64,1,63,1.58730158730159
"9130","8/3/2008",126,1,125,0.8
"9131","8/3/2009",73,0,73,0
"9132","8/3/2010",68,2,66,3.03030303030303
"9133","8/3/2011",78,5,73,6.84931506849315
"9134","8/3/2012",67,2,65,3.07692307692308
"9135","8/3/2013",59,8,51,15.6862745098039
"9136","8/3/2014",127,7,120,5.83333333333333
"9137","8/3/2015",75,0,75,0
"9138","8/3/2016",74,1,73,1.36986301369863
"9139","8/3/2017",71,6,65,9.23076923076923
"9140","8/3/2018",67,3,64,4.6875
"9141","8/3/2019",57,3,54,5.55555555555556
"9142","8/3/2020",70,1,69,1.44927536231884
"9143","8/3/2021",76,2,74,2.7027027027027
"9144","8/30/1994",74,0,74,0
"9145","8/30/1995",69,0,69,0
"9146","8/30/1996",59,2,57,3.50877192982456
"9147","8/30/1997",56,2,54,3.7037037037037
"9148","8/30/1998",129,3,126,2.38095238095238
"9149","8/30/1999",71,0,71,0
"9150","8/30/2000",72,2,70,2.85714285714286
"9151","8/30/2001",69,5,64,7.8125
"9152","8/30/2002",70,3,67,4.47761194029851
"9153","8/30/2003",56,5,51,9.80392156862745
"9154","8/30/2004",75,0,75,0
"9155","8/30/2005",72,1,71,1.40845070422535
"9156","8/30/2006",71,3,68,4.41176470588235
"9157","8/30/2007",64,1,63,1.58730158730159
"9158","8/30/2008",65,2,63,3.17460317460317
"9159","8/30/2009",130,3,127,2.36220472440945
"9160","8/30/2010",70,1,69,1.44927536231884
"9161","8/30/2011",72,1,71,1.40845070422535
"9162","8/30/2012",67,4,63,6.34920634920635
"9163","8/30/2013",61,4,57,7.01754385964912
"9164","8/30/2014",63,6,57,10.5263157894737
"9165","8/30/2015",129,5,124,4.03225806451613
"9166","8/30/2016",71,1,70,1.42857142857143
"9167","8/30/2017",77,5,72,6.94444444444444
"9168","8/30/2018",68,3,65,4.61538461538462
"9169","8/30/2019",61,3,58,5.17241379310345
"9170","8/30/2020",131,5,126,3.96825396825397
"9171","8/30/2021",71,1,70,1.42857142857143
"9172","8/31/1994",64,0,64,0
"9173","8/31/1995",63,0,63,0
"9174","8/31/1996",64,0,64,0
"9175","8/31/1997",113,2,111,1.8018018018018
"9176","8/31/1998",71,1,70,1.42857142857143
"9177","8/31/1999",76,1,75,1.33333333333333
"9178","8/31/2000",69,4,65,6.15384615384615
"9179","8/31/2001",64,4,60,6.66666666666667
"9180","8/31/2002",62,1,61,1.63934426229508
"9181","8/31/2003",129,5,124,4.03225806451613
"9182","8/31/2004",72,1,71,1.40845070422535
"9183","8/31/2005",70,3,67,4.47761194029851
"9184","8/31/2006",69,2,67,2.98507462686567
"9185","8/31/2007",59,4,55,7.27272727272727
"9186","8/31/2008",123,4,119,3.36134453781513
"9187","8/31/2009",75,0,75,0
"9188","8/31/2010",75,0,75,0
"9189","8/31/2011",74,2,72,2.77777777777778
"9190","8/31/2012",59,4,55,7.27272727272727
"9191","8/31/2013",63,6,57,10.5263157894737
"9192","8/31/2014",124,10,114,8.7719298245614
"9193","8/31/2015",74,0,74,0
"9194","8/31/2016",70,0,70,0
"9195","8/31/2017",73,2,71,2.8169014084507
"9196","8/31/2018",64,7,57,12.280701754386
"9197","8/31/2019",59,2,57,3.50877192982456
"9198","8/31/2020",75,1,74,1.35135135135135
"9199","8/31/2021",72,3,69,4.34782608695652
"9200","8/4/1994",66,3,63,4.76190476190476
"9201","8/4/1995",68,1,67,1.49253731343284
"9202","8/4/1996",119,3,116,2.58620689655172
"9203","8/4/1997",76,0,76,0
"9204","8/4/1998",76,2,74,2.7027027027027
"9205","8/4/1999",74,2,72,2.77777777777778
"9206","8/4/2000",63,0,63,0
"9207","8/4/2001",46,0,46,0
"9208","8/4/2002",131,1,130,0.769230769230769
"9209","8/4/2003",67,0,67,0
"9210","8/4/2004",71,0,71,0
"9211","8/4/2005",70,4,66,6.06060606060606
"9212","8/4/2006",58,4,54,7.40740740740741
"9213","8/4/2007",54,3,51,5.88235294117647
"9214","8/4/2008",68,1,67,1.49253731343284
"9215","8/4/2009",74,3,71,4.22535211267606
"9216","8/4/2010",68,2,66,3.03030303030303
"9217","8/4/2011",65,10,55,18.1818181818182
"9218","8/4/2012",63,3,60,5
"9219","8/4/2013",119,3,116,2.58620689655172
"9220","8/4/2014",64,1,63,1.58730158730159
"9221","8/4/2015",67,4,63,6.34920634920635
"9222","8/4/2016",67,2,65,3.07692307692308
"9223","8/4/2017",67,0,67,0
"9224","8/4/2018",65,7,58,12.0689655172414
"9225","8/4/2019",121,3,118,2.54237288135593
"9226","8/4/2020",72,1,71,1.40845070422535
"9227","8/4/2021",70,2,68,2.94117647058824
"9228","8/5/1994",66,0,66,0
"9229","8/5/1995",52,0,52,0
"9230","8/5/1996",70,0,70,0
"9231","8/5/1997",76,2,74,2.7027027027027
"9232","8/5/1998",73,2,71,2.8169014084507
"9233","8/5/1999",67,0,67,0
"9234","8/5/2000",59,3,56,5.35714285714286
"9235","8/5/2001",120,4,116,3.44827586206897
"9236","8/5/2002",69,1,68,1.47058823529412
"9237","8/5/2003",72,2,70,2.85714285714286
"9238","8/5/2004",71,2,69,2.89855072463768
"9239","8/5/2005",66,5,61,8.19672131147541
"9240","8/5/2006",54,2,52,3.84615384615385
"9241","8/5/2007",122,1,121,0.826446280991736
"9242","8/5/2008",75,4,71,5.63380281690141
"9243","8/5/2009",68,1,67,1.49253731343284
"9244","8/5/2010",70,0,70,0
"9245","8/5/2011",69,8,61,13.1147540983607
"9246","8/5/2012",131,2,129,1.55038759689922
"9247","8/5/2013",67,0,67,0
"9248","8/5/2014",75,3,72,4.16666666666667
"9249","8/5/2015",69,3,66,4.54545454545455
"9250","8/5/2016",64,5,59,8.47457627118644
"9251","8/5/2017",68,10,58,17.2413793103448
"9252","8/5/2018",135,11,124,8.87096774193548
"9253","8/5/2019",75,1,74,1.35135135135135
"9254","8/5/2020",71,5,66,7.57575757575758
"9255","8/5/2021",72,4,68,5.88235294117647
"9256","8/6/1994",66,1,65,1.53846153846154
"9257","8/6/1995",118,4,114,3.50877192982456
"9258","8/6/1996",69,1,68,1.47058823529412
"9259","8/6/1997",71,1,70,1.42857142857143
"9260","8/6/1998",65,0,65,0
"9261","8/6/1999",61,5,56,8.92857142857143
"9262","8/6/2000",125,3,122,2.45901639344262
"9263","8/6/2001",70,2,68,2.94117647058824
"9264","8/6/2002",72,2,70,2.85714285714286
"9265","8/6/2003",73,0,73,0
"9266","8/6/2004",60,0,60,0
"9267","8/6/2005",44,2,42,4.76190476190476
"9268","8/6/2006",126,4,122,3.27868852459016
"9269","8/6/2007",78,0,78,0
"9270","8/6/2008",76,0,76,0
"9271","8/6/2009",67,3,64,4.6875
"9272","8/6/2010",60,2,58,3.44827586206897
"9273","8/6/2011",64,4,60,6.66666666666667
"9274","8/6/2012",74,1,73,1.36986301369863
"9275","8/6/2013",70,1,69,1.44927536231884
"9276","8/6/2014",73,3,70,4.28571428571429
"9277","8/6/2015",73,3,70,4.28571428571429
"9278","8/6/2016",63,6,57,10.5263157894737
"9279","8/6/2017",130,7,123,5.69105691056911
"9280","8/6/2018",71,1,70,1.42857142857143
"9281","8/6/2019",71,2,69,2.89855072463768
"9282","8/6/2020",73,5,68,7.35294117647059
"9283","8/6/2021",66,4,62,6.45161290322581
"9284","8/7/1994",127,1,126,0.793650793650794
"9285","8/7/1995",73,0,73,0
"9286","8/7/1996",74,0,74,0
"9287","8/7/1997",66,0,66,0
"9288","8/7/1998",52,0,52,0
"9289","8/7/1999",52,1,51,1.96078431372549
"9290","8/7/2000",73,0,73,0
"9291","8/7/2001",76,0,76,0
"9292","8/7/2002",74,5,69,7.2463768115942
"9293","8/7/2003",66,1,65,1.53846153846154
"9294","8/7/2004",53,0,53,0
"9295","8/7/2005",131,3,128,2.34375
"9296","8/7/2006",71,1,70,1.42857142857143
"9297","8/7/2007",72,1,71,1.40845070422535
"9298","8/7/2008",68,4,64,6.25
"9299","8/7/2009",60,1,59,1.69491525423729
"9300","8/7/2010",52,2,50,4
"9301","8/7/2011",130,5,125,4
"9302","8/7/2012",68,0,68,0
"9303","8/7/2013",70,1,69,1.44927536231884
"9304","8/7/2014",66,5,61,8.19672131147541
"9305","8/7/2015",61,0,61,0
"9306","8/7/2016",131,6,125,4.8
"9307","8/7/2017",75,0,75,0
"9308","8/7/2018",71,3,68,4.41176470588235
"9309","8/7/2019",75,2,73,2.73972602739726
"9310","8/7/2020",62,1,61,1.63934426229508
"9311","8/7/2021",62,6,56,10.7142857142857
"9312","8/8/1994",73,2,71,2.8169014084507
"9313","8/8/1995",77,1,76,1.31578947368421
"9314","8/8/1996",63,1,62,1.61290322580645
"9315","8/8/1997",63,1,62,1.61290322580645
"9316","8/8/1998",58,1,57,1.75438596491228
"9317","8/8/1999",130,1,129,0.775193798449612
"9318","8/8/2000",69,1,68,1.47058823529412
"9319","8/8/2001",71,4,67,5.97014925373134
"9320","8/8/2002",71,3,68,4.41176470588235
"9321","8/8/2003",56,1,55,1.81818181818182
"9322","8/8/2004",134,4,130,3.07692307692308
"9323","8/8/2005",70,0,70,0
"9324","8/8/2006",74,1,73,1.36986301369863
"9325","8/8/2007",67,0,67,0
"9326","8/8/2008",64,8,56,14.2857142857143
"9327","8/8/2009",61,6,55,10.9090909090909
"9328","8/8/2010",130,4,126,3.17460317460317
"9329","8/8/2011",74,0,74,0
"9330","8/8/2012",73,1,72,1.38888888888889
"9331","8/8/2013",69,2,67,2.98507462686567
"9332","8/8/2014",65,3,62,4.83870967741935
"9333","8/8/2015",63,10,53,18.8679245283019
"9334","8/8/2016",74,0,74,0
"9335","8/8/2017",75,1,74,1.35135135135135
"9336","8/8/2018",77,1,76,1.31578947368421
"9337","8/8/2019",70,5,65,7.69230769230769
"9338","8/8/2020",59,0,59,0
"9339","8/8/2021",121,7,114,6.14035087719298
"9340","8/9/1994",71,0,71,0
"9341","8/9/1995",70,0,70,0
"9342","8/9/1996",63,1,62,1.61290322580645
"9343","8/9/1997",62,1,61,1.63934426229508
"9344","8/9/1998",117,3,114,2.63157894736842
"9345","8/9/1999",72,0,72,0
"9346","8/9/2000",71,3,68,4.41176470588235
"9347","8/9/2001",63,1,62,1.61290322580645
"9348","8/9/2002",63,3,60,5
"9349","8/9/2003",64,2,62,3.2258064516129
"9350","8/9/2004",67,2,65,3.07692307692308
"9351","8/9/2005",71,0,71,0
"9352","8/9/2006",75,4,71,5.63380281690141
"9353","8/9/2007",71,1,70,1.42857142857143
"9354","8/9/2008",49,2,47,4.25531914893617
"9355","8/9/2009",132,7,125,5.6
"9356","8/9/2010",73,0,73,0
"9357","8/9/2011",73,3,70,4.28571428571429
"9358","8/9/2012",62,2,60,3.33333333333333
"9359","8/9/2013",61,6,55,10.9090909090909
"9360","8/9/2014",56,1,55,1.81818181818182
"9361","8/9/2015",131,9,122,7.37704918032787
"9362","8/9/2016",77,1,76,1.31578947368421
"9363","8/9/2017",74,0,74,0
"9364","8/9/2018",73,3,70,4.28571428571429
"9365","8/9/2019",65,2,63,3.17460317460317
"9366","8/9/2020",132,3,129,2.32558139534884
"9367","8/9/2021",72,5,67,7.46268656716418
"9368","9/1/1994",71,2,69,2.89855072463768
"9369","9/1/1995",67,2,65,3.07692307692308
"9370","9/1/1996",129,3,126,2.38095238095238
"9371","9/1/1997",75,1,74,1.35135135135135
"9372","9/1/1998",69,1,68,1.47058823529412
"9373","9/1/1999",71,1,70,1.42857142857143
"9374","9/1/2000",58,3,55,5.45454545454545
"9375","9/1/2001",67,3,64,4.6875
"9376","9/1/2002",122,3,119,2.52100840336134
"9377","9/1/2003",75,0,75,0
"9378","9/1/2004",72,1,71,1.40845070422535
"9379","9/1/2005",77,0,77,0
"9380","9/1/2006",60,5,55,9.09090909090909
"9381","9/1/2007",58,2,56,3.57142857142857
"9382","9/1/2008",78,0,78,0
"9383","9/1/2009",73,0,73,0
"9384","9/1/2010",73,2,71,2.8169014084507
"9385","9/1/2011",67,2,65,3.07692307692308
"9386","9/1/2012",63,4,59,6.77966101694915
"9387","9/1/2013",119,5,114,4.3859649122807
"9388","9/1/2014",74,0,74,0
"9389","9/1/2015",71,0,71,0
"9390","9/1/2016",75,2,73,2.73972602739726
"9391","9/1/2017",58,2,56,3.57142857142857
"9392","9/1/2018",60,1,59,1.69491525423729
"9393","9/1/2019",123,4,119,3.36134453781513
"9394","9/1/2020",73,2,71,2.8169014084507
"9395","9/1/2021",63,2,61,3.27868852459016
"9396","9/10/1994",62,1,61,1.63934426229508
"9397","9/10/1995",121,1,120,0.833333333333333
"9398","9/10/1996",77,0,77,0
"9399","9/10/1997",74,0,74,0
"9400","9/10/1998",67,1,66,1.51515151515152
"9401","9/10/1999",70,2,68,2.94117647058824
"9402","9/10/2000",125,5,120,4.16666666666667
"9403","9/10/2001",74,1,73,1.36986301369863
"9404","9/10/2002",76,2,74,2.7027027027027
"9405","9/10/2003",55,2,53,3.77358490566038
"9406","9/10/2004",50,1,49,2.04081632653061
"9407","9/10/2005",63,0,63,0
"9408","9/10/2006",116,2,114,1.75438596491228
"9409","9/10/2007",74,0,74,0
"9410","9/10/2008",78,1,77,1.2987012987013
"9411","9/10/2009",75,1,74,1.35135135135135
"9412","9/10/2010",65,1,64,1.5625
"9413","9/10/2011",62,3,59,5.08474576271187
"9414","9/10/2012",74,0,74,0
"9415","9/10/2013",78,0,78,0
"9416","9/10/2014",70,3,67,4.47761194029851
"9417","9/10/2015",73,5,68,7.35294117647059
"9418","9/10/2016",61,3,58,5.17241379310345
"9419","9/10/2017",124,1,123,0.813008130081301
"9420","9/10/2018",74,2,72,2.77777777777778
"9421","9/10/2019",70,0,70,0
"9422","9/10/2020",72,1,71,1.40845070422535
"9423","9/10/2021",59,0,59,0
"9424","9/11/1994",132,4,128,3.125
"9425","9/11/1995",75,0,75,0
"9426","9/11/1996",73,4,69,5.79710144927536
"9427","9/11/1997",67,2,65,3.07692307692308
"9428","9/11/1998",63,3,60,5
"9429","9/11/1999",66,4,62,6.45161290322581
"9430","9/11/2000",76,0,76,0
"9431","9/11/2001",74,1,73,1.36986301369863
"9432","9/11/2002",75,1,74,1.35135135135135
"9433","9/11/2003",78,4,74,5.40540540540541
"9434","9/11/2004",53,4,49,8.16326530612245
"9435","9/11/2005",125,3,122,2.45901639344262
"9436","9/11/2006",70,0,70,0
"9437","9/11/2007",72,2,70,2.85714285714286
"9438","9/11/2008",73,1,72,1.38888888888889
"9439","9/11/2009",68,1,67,1.49253731343284
"9440","9/11/2010",62,8,54,14.8148148148148
"9441","9/11/2011",120,3,117,2.56410256410256
"9442","9/11/2012",65,2,63,3.17460317460317
"9443","9/11/2013",74,7,67,10.4477611940298
"9444","9/11/2014",82,4,78,5.12820512820513
"9445","9/11/2015",59,4,55,7.27272727272727
"9446","9/11/2016",131,3,128,2.34375
"9447","9/11/2017",71,1,70,1.42857142857143
"9448","9/11/2018",68,2,66,3.03030303030303
"9449","9/11/2019",68,3,65,4.61538461538462
"9450","9/11/2020",66,4,62,6.45161290322581
"9451","9/11/2021",56,3,53,5.66037735849057
"9452","9/12/1994",76,1,75,1.33333333333333
"9453","9/12/1995",76,0,76,0
"9454","9/12/1996",68,2,66,3.03030303030303
"9455","9/12/1997",57,0,57,0
"9456","9/12/1998",70,0,70,0
"9457","9/12/1999",127,5,122,4.0983606557377
"9458","9/12/2000",76,1,75,1.33333333333333
"9459","9/12/2001",73,3,70,4.28571428571429
"9460","9/12/2002",65,6,59,10.1694915254237
"9461","9/12/2003",65,7,58,12.0689655172414
"9462","9/12/2004",116,4,112,3.57142857142857
"9463","9/12/2005",70,0,70,0
"9464","9/12/2006",69,0,69,0
"9465","9/12/2007",67,2,65,3.07692307692308
"9466","9/12/2008",65,6,59,10.1694915254237
"9467","9/12/2009",63,4,59,6.77966101694915
"9468","9/12/2010",116,3,113,2.65486725663717
"9469","9/12/2011",73,0,73,0
"9470","9/12/2012",73,5,68,7.35294117647059
"9471","9/12/2013",67,4,63,6.34920634920635
"9472","9/12/2014",59,1,58,1.72413793103448
"9473","9/12/2015",62,5,57,8.7719298245614
"9474","9/12/2016",73,2,71,2.8169014084507
"9475","9/12/2017",71,3,68,4.41176470588235
"9476","9/12/2018",66,1,65,1.53846153846154
"9477","9/12/2019",68,2,66,3.03030303030303
"9478","9/12/2020",49,4,45,8.88888888888889
"9479","9/12/2021",140,4,136,2.94117647058824
"9480","9/13/1994",69,0,69,0
"9481","9/13/1995",65,0,65,0
"9482","9/13/1996",61,1,60,1.66666666666667
"9483","9/13/1997",61,0,61,0
"9484","9/13/1998",128,3,125,2.4
"9485","9/13/1999",76,0,76,0
"9486","9/13/2000",70,1,69,1.44927536231884
"9487","9/13/2001",62,0,62,0
"9488","9/13/2002",60,1,59,1.69491525423729
"9489","9/13/2003",66,0,66,0
"9490","9/13/2004",73,0,73,0
"9491","9/13/2005",70,2,68,2.94117647058824
"9492","9/13/2006",74,2,72,2.77777777777778
"9493","9/13/2007",66,4,62,6.45161290322581
"9494","9/13/2008",67,3,64,4.6875
"9495","9/13/2009",121,1,120,0.833333333333333
"9496","9/13/2010",73,1,72,1.38888888888889
"9497","9/13/2011",70,2,68,2.94117647058824
"9498","9/13/2012",75,4,71,5.63380281690141
"9499","9/13/2013",60,5,55,9.09090909090909
"9500","9/13/2014",60,4,56,7.14285714285714
"9501","9/13/2015",121,9,112,8.03571428571429
"9502","9/13/2016",74,2,72,2.77777777777778
"9503","9/13/2017",71,1,70,1.42857142857143
"9504","9/13/2018",71,6,65,9.23076923076923
"9505","9/13/2019",67,2,65,3.07692307692308
"9506","9/13/2020",127,1,126,0.793650793650794
"9507","9/13/2021",76,4,72,5.55555555555556
"9508","9/14/1994",69,1,68,1.47058823529412
"9509","9/14/1995",70,1,69,1.44927536231884
"9510","9/14/1996",69,1,68,1.47058823529412
"9511","9/14/1997",114,4,110,3.63636363636364
"9512","9/14/1998",78,0,78,0
"9513","9/14/1999",76,1,75,1.33333333333333
"9514","9/14/2000",68,3,65,4.61538461538462
"9515","9/14/2001",57,5,52,9.61538461538462
"9516","9/14/2002",57,2,55,3.63636363636364
"9517","9/14/2003",127,3,124,2.41935483870968
"9518","9/14/2004",77,2,75,2.66666666666667
"9519","9/14/2005",72,1,71,1.40845070422535
"9520","9/14/2006",71,2,69,2.89855072463768
"9521","9/14/2007",63,2,61,3.27868852459016
"9522","9/14/2008",125,5,120,4.16666666666667
"9523","9/14/2009",73,2,71,2.8169014084507
"9524","9/14/2010",76,3,73,4.10958904109589
"9525","9/14/2011",70,0,70,0
"9526","9/14/2012",64,6,58,10.3448275862069
"9527","9/14/2013",63,5,58,8.62068965517241
"9528","9/14/2014",128,5,123,4.0650406504065
"9529","9/14/2015",69,2,67,2.98507462686567
"9530","9/14/2016",78,1,77,1.2987012987013
"9531","9/14/2017",62,4,58,6.89655172413793
"9532","9/14/2018",63,3,60,5
"9533","9/14/2019",63,4,59,6.77966101694915
"9534","9/14/2020",72,1,71,1.40845070422535
"9535","9/14/2021",70,4,66,6.06060606060606
"9536","9/15/1994",71,2,69,2.89855072463768
"9537","9/15/1995",55,1,54,1.85185185185185
"9538","9/15/1996",114,5,109,4.58715596330275
"9539","9/15/1997",73,0,73,0
"9540","9/15/1998",72,0,72,0
"9541","9/15/1999",72,1,71,1.40845070422535
"9542","9/15/2000",57,6,51,11.7647058823529
"9543","9/15/2001",70,3,67,4.47761194029851
"9544","9/15/2002",126,5,121,4.13223140495868
"9545","9/15/2003",73,4,69,5.79710144927536
"9546","9/15/2004",71,0,71,0
"9547","9/15/2005",68,2,66,3.03030303030303
"9548","9/15/2006",66,3,63,4.76190476190476
"9549","9/15/2007",65,2,63,3.17460317460317
"9550","9/15/2008",76,0,76,0
"9551","9/15/2009",70,2,68,2.94117647058824
"9552","9/15/2010",70,3,67,4.47761194029851
"9553","9/15/2011",63,4,59,6.77966101694915
"9554","9/15/2012",61,8,53,15.0943396226415
"9555","9/15/2013",122,4,118,3.38983050847458
"9556","9/15/2014",73,0,73,0
"9557","9/15/2015",72,2,70,2.85714285714286
"9558","9/15/2016",70,2,68,2.94117647058824
"9559","9/15/2017",67,2,65,3.07692307692308
"9560","9/15/2018",67,3,64,4.6875
"9561","9/15/2019",133,13,120,10.8333333333333
"9562","9/15/2020",71,1,70,1.42857142857143
"9563","9/15/2021",68,5,63,7.93650793650794
"9564","9/16/1994",66,0,66,0
"9565","9/16/1995",65,1,64,1.5625
"9566","9/16/1996",74,0,74,0
"9567","9/16/1997",74,0,74,0
"9568","9/16/1998",77,3,74,4.05405405405405
"9569","9/16/1999",66,3,63,4.76190476190476
"9570","9/16/2000",63,8,55,14.5454545454545
"9571","9/16/2001",134,5,129,3.87596899224806
"9572","9/16/2002",74,1,73,1.36986301369863
"9573","9/16/2003",71,2,69,2.89855072463768
"9574","9/16/2004",72,7,65,10.7692307692308
"9575","9/16/2005",68,5,63,7.93650793650794
"9576","9/16/2006",61,4,57,7.01754385964912
"9577","9/16/2007",129,3,126,2.38095238095238
"9578","9/16/2008",73,4,69,5.79710144927536
"9579","9/16/2009",71,2,69,2.89855072463768
"9580","9/16/2010",75,3,72,4.16666666666667
"9581","9/16/2011",55,4,51,7.84313725490196
"9582","9/16/2012",131,4,127,3.1496062992126
"9583","9/16/2013",76,1,75,1.33333333333333
"9584","9/16/2014",71,0,71,0
"9585","9/16/2015",65,2,63,3.17460317460317
"9586","9/16/2016",60,5,55,9.09090909090909
"9587","9/16/2017",62,8,54,14.8148148148148
"9588","9/16/2018",120,8,112,7.14285714285714
"9589","9/16/2019",75,2,73,2.73972602739726
"9590","9/16/2020",75,6,69,8.69565217391304
"9591","9/16/2021",71,3,68,4.41176470588235
"9592","9/17/1994",65,2,63,3.17460317460317
"9593","9/17/1995",125,1,124,0.806451612903226
"9594","9/17/1996",78,0,78,0
"9595","9/17/1997",71,4,67,5.97014925373134
"9596","9/17/1998",64,0,64,0
"9597","9/17/1999",54,3,51,5.88235294117647
"9598","9/17/2000",127,3,124,2.41935483870968
"9599","9/17/2001",70,1,69,1.44927536231884
"9600","9/17/2002",75,0,75,0
"9601","9/17/2003",77,5,72,6.94444444444444
"9602","9/17/2004",59,3,56,5.35714285714286
"9603","9/17/2005",60,2,58,3.44827586206897
"9604","9/17/2006",126,3,123,2.4390243902439
"9605","9/17/2007",73,0,73,0
"9606","9/17/2008",69,1,68,1.47058823529412
"9607","9/17/2009",68,2,66,3.03030303030303
"9608","9/17/2010",57,6,51,11.7647058823529
"9609","9/17/2011",63,2,61,3.27868852459016
"9610","9/17/2012",74,2,72,2.77777777777778
"9611","9/17/2013",75,1,74,1.35135135135135
"9612","9/17/2014",76,0,76,0
"9613","9/17/2015",69,4,65,6.15384615384615
"9614","9/17/2016",64,4,60,6.66666666666667
"9615","9/17/2017",126,5,121,4.13223140495868
"9616","9/17/2018",70,0,70,0
"9617","9/17/2019",74,6,68,8.82352941176471
"9618","9/17/2020",67,4,63,6.34920634920635
"9619","9/17/2021",61,3,58,5.17241379310345
"9620","9/18/1994",122,1,121,0.826446280991736
"9621","9/18/1995",75,1,74,1.35135135135135
"9622","9/18/1996",69,0,69,0
"9623","9/18/1997",70,0,70,0
"9624","9/18/1998",55,2,53,3.77358490566038
"9625","9/18/1999",64,5,59,8.47457627118644
"9626","9/18/2000",74,3,71,4.22535211267606
"9627","9/18/2001",69,1,68,1.47058823529412
"9628","9/18/2002",69,3,66,4.54545454545455
"9629","9/18/2003",72,2,70,2.85714285714286
"9630","9/18/2004",61,1,60,1.66666666666667
"9631","9/18/2005",124,3,121,2.47933884297521
"9632","9/18/2006",73,0,73,0
"9633","9/18/2007",72,2,70,2.85714285714286
"9634","9/18/2008",74,3,71,4.22535211267606
"9635","9/18/2009",66,2,64,3.125
"9636","9/18/2010",61,4,57,7.01754385964912
"9637","9/18/2011",125,6,119,5.04201680672269
"9638","9/18/2012",74,2,72,2.77777777777778
"9639","9/18/2013",67,5,62,8.06451612903226
"9640","9/18/2014",74,5,69,7.2463768115942
"9641","9/18/2015",63,4,59,6.77966101694915
"9642","9/18/2016",118,4,114,3.50877192982456
"9643","9/18/2017",76,0,76,0
"9644","9/18/2018",72,1,71,1.40845070422535
"9645","9/18/2019",74,1,73,1.36986301369863
"9646","9/18/2020",62,3,59,5.08474576271187
"9647","9/18/2021",54,7,47,14.8936170212766
"9648","9/19/1994",75,1,74,1.35135135135135
"9649","9/19/1995",72,0,72,0
"9650","9/19/1996",63,1,62,1.61290322580645
"9651","9/19/1997",61,0,61,0
"9652","9/19/1998",65,1,64,1.5625
"9653","9/19/1999",163,12,151,7.94701986754967
"9654","9/19/2000",70,1,69,1.44927536231884
"9655","9/19/2001",68,0,68,0
"9656","9/19/2002",69,1,68,1.47058823529412
"9657","9/19/2003",63,1,62,1.61290322580645
"9658","9/19/2004",132,2,130,1.53846153846154
"9659","9/19/2005",70,1,69,1.44927536231884
"9660","9/19/2006",75,0,75,0
"9661","9/19/2007",70,2,68,2.94117647058824
"9662","9/19/2008",66,2,64,3.125
"9663","9/19/2009",53,2,51,3.92156862745098
"9664","9/19/2010",128,6,122,4.91803278688525
"9665","9/19/2011",70,0,70,0
"9666","9/19/2012",63,11,52,21.1538461538462
"9667","9/19/2013",66,1,65,1.53846153846154
"9668","9/19/2014",65,2,63,3.17460317460317
"9669","9/19/2015",51,3,48,6.25
"9670","9/19/2016",77,1,76,1.31578947368421
"9671","9/19/2017",69,2,67,2.98507462686567
"9672","9/19/2018",74,0,74,0
"9673","9/19/2019",74,2,72,2.77777777777778
"9674","9/19/2020",63,6,57,10.5263157894737
"9675","9/19/2021",123,7,116,6.03448275862069
"9676","9/2/1994",63,1,62,1.61290322580645
"9677","9/2/1995",61,2,59,3.38983050847458
"9678","9/2/1996",72,0,72,0
"9679","9/2/1997",72,1,71,1.40845070422535
"9680","9/2/1998",72,4,68,5.88235294117647
"9681","9/2/1999",60,2,58,3.44827586206897
"9682","9/2/2000",61,2,59,3.38983050847458
"9683","9/2/2001",113,4,109,3.6697247706422
"9684","9/2/2002",73,1,72,1.38888888888889
"9685","9/2/2003",73,0,73,0
"9686","9/2/2004",65,4,61,6.55737704918033
"9687","9/2/2005",61,0,61,0
"9688","9/2/2006",59,5,54,9.25925925925926
"9689","9/2/2007",130,3,127,2.36220472440945
"9690","9/2/2008",73,0,73,0
"9691","9/2/2009",73,2,71,2.8169014084507
"9692","9/2/2010",76,5,71,7.04225352112676
"9693","9/2/2011",62,3,59,5.08474576271187
"9694","9/2/2012",123,5,118,4.23728813559322
"9695","9/2/2013",75,0,75,0
"9696","9/2/2014",65,2,63,3.17460317460317
"9697","9/2/2015",67,2,65,3.07692307692308
"9698","9/2/2016",60,6,54,11.1111111111111
"9699","9/2/2017",51,7,44,15.9090909090909
"9700","9/2/2018",129,2,127,1.5748031496063
"9701","9/2/2019",75,1,74,1.35135135135135
"9702","9/2/2020",71,3,68,4.41176470588235
"9703","9/2/2021",77,6,71,8.45070422535211
"9704","9/20/1994",70,2,68,2.94117647058824
"9705","9/20/1995",72,1,71,1.40845070422535
"9706","9/20/1996",61,1,60,1.66666666666667
"9707","9/20/1997",59,7,52,13.4615384615385
"9708","9/20/1998",125,1,124,0.806451612903226
"9709","9/20/1999",78,0,78,0
"9710","9/20/2000",69,2,67,2.98507462686567
"9711","9/20/2001",67,3,64,4.6875
"9712","9/20/2002",58,3,55,5.45454545454545
"9713","9/20/2003",61,0,61,0
"9714","9/20/2004",73,0,73,0
"9715","9/20/2005",75,0,75,0
"9716","9/20/2006",73,6,67,8.95522388059701
"9717","9/20/2007",78,2,76,2.63157894736842
"9718","9/20/2008",52,3,49,6.12244897959184
"9719","9/20/2009",129,2,127,1.5748031496063
"9720","9/20/2010",71,2,69,2.89855072463768
"9721","9/20/2011",74,0,74,0
"9722","9/20/2012",68,2,66,3.03030303030303
"9723","9/20/2013",65,4,61,6.55737704918033
"9724","9/20/2014",60,8,52,15.3846153846154
"9725","9/20/2015",136,4,132,3.03030303030303
"9726","9/20/2016",70,1,69,1.44927536231884
"9727","9/20/2017",76,0,76,0
"9728","9/20/2018",58,2,56,3.57142857142857
"9729","9/20/2019",56,1,55,1.81818181818182
"9730","9/20/2020",124,5,119,4.20168067226891
"9731","9/20/2021",73,0,73,0
"9732","9/21/1994",63,0,63,0
"9733","9/21/1995",67,2,65,3.07692307692308
"9734","9/21/1996",62,2,60,3.33333333333333
"9735","9/21/1997",122,0,122,0
"9736","9/21/1998",70,0,70,0
"9737","9/21/1999",71,1,70,1.42857142857143
"9738","9/21/2000",67,4,63,6.34920634920635
"9739","9/21/2001",62,4,58,6.89655172413793
"9740","9/21/2002",61,0,61,0
"9741","9/21/2003",134,1,133,0.75187969924812
"9742","9/21/2004",74,2,72,2.77777777777778
"9743","9/21/2005",74,0,74,0
"9744","9/21/2006",72,1,71,1.40845070422535
"9745","9/21/2007",62,2,60,3.33333333333333
"9746","9/21/2008",127,4,123,3.2520325203252
"9747","9/21/2009",72,1,71,1.40845070422535
"9748","9/21/2010",75,0,75,0
"9749","9/21/2011",75,5,70,7.14285714285714
"9750","9/21/2012",61,4,57,7.01754385964912
"9751","9/21/2013",41,4,37,10.8108108108108
"9752","9/21/2014",123,8,115,6.95652173913043
"9753","9/21/2015",73,0,73,0
"9754","9/21/2016",65,0,65,0
"9755","9/21/2017",65,2,63,3.17460317460317
"9756","9/21/2018",63,3,60,5
"9757","9/21/2019",56,8,48,16.6666666666667
"9758","9/21/2020",75,3,72,4.16666666666667
"9759","9/21/2021",72,4,68,5.88235294117647
"9760","9/22/1994",73,2,71,2.8169014084507
"9761","9/22/1995",65,0,65,0
"9762","9/22/1996",122,2,120,1.66666666666667
"9763","9/22/1997",76,0,76,0
"9764","9/22/1998",75,4,71,5.63380281690141
"9765","9/22/1999",65,0,65,0
"9766","9/22/2000",55,1,54,1.85185185185185
"9767","9/22/2001",63,5,58,8.62068965517241
"9768","9/22/2002",126,1,125,0.8
"9769","9/22/2003",73,1,72,1.38888888888889
"9770","9/22/2004",71,0,71,0
"9771","9/22/2005",67,0,67,0
"9772","9/22/2006",55,3,52,5.76923076923077
"9773","9/22/2007",51,3,48,6.25
"9774","9/22/2008",73,0,73,0
"9775","9/22/2009",72,1,71,1.40845070422535
"9776","9/22/2010",68,3,65,4.61538461538462
"9777","9/22/2011",68,3,65,4.61538461538462
"9778","9/22/2012",67,6,61,9.83606557377049
"9779","9/22/2013",131,4,127,3.1496062992126
"9780","9/22/2014",70,0,70,0
"9781","9/22/2015",75,3,72,4.16666666666667
"9782","9/22/2016",70,4,66,6.06060606060606
"9783","9/22/2017",65,5,60,8.33333333333333
"9784","9/22/2018",53,1,52,1.92307692307692
"9785","9/22/2019",126,6,120,5
"9786","9/22/2020",73,1,72,1.38888888888889
"9787","9/22/2021",70,2,68,2.94117647058824
"9788","9/23/1994",69,1,68,1.47058823529412
"9789","9/23/1995",62,4,58,6.89655172413793
"9790","9/23/1996",76,0,76,0
"9791","9/23/1997",66,0,66,0
"9792","9/23/1998",74,0,74,0
"9793","9/23/1999",61,0,61,0
"9794","9/23/2000",61,1,60,1.66666666666667
"9795","9/23/2001",125,2,123,1.6260162601626
"9796","9/23/2002",75,1,74,1.35135135135135
"9797","9/23/2003",76,0,76,0
"9798","9/23/2004",75,4,71,5.63380281690141
"9799","9/23/2005",61,3,58,5.17241379310345
"9800","9/23/2006",70,5,65,7.69230769230769
"9801","9/23/2007",127,3,124,2.41935483870968
"9802","9/23/2008",75,0,75,0
"9803","9/23/2009",73,1,72,1.38888888888889
"9804","9/23/2010",71,3,68,4.41176470588235
"9805","9/23/2011",67,3,64,4.6875
"9806","9/23/2012",127,8,119,6.72268907563025
"9807","9/23/2013",69,1,68,1.47058823529412
"9808","9/23/2014",71,2,69,2.89855072463768
"9809","9/23/2015",73,5,68,7.35294117647059
"9810","9/23/2016",61,5,56,8.92857142857143
"9811","9/23/2017",65,3,62,4.83870967741935
"9812","9/23/2018",129,5,124,4.03225806451613
"9813","9/23/2019",77,0,77,0
"9814","9/23/2020",68,1,67,1.49253731343284
"9815","9/23/2021",64,4,60,6.66666666666667
"9816","9/24/1994",56,0,56,0
"9817","9/24/1995",119,0,119,0
"9818","9/24/1996",72,0,72,0
"9819","9/24/1997",73,1,72,1.38888888888889
"9820","9/24/1998",71,2,69,2.89855072463768
"9821","9/24/1999",66,2,64,3.125
"9822","9/24/2000",116,1,115,0.869565217391304
"9823","9/24/2001",78,0,78,0
"9824","9/24/2002",72,2,70,2.85714285714286
"9825","9/24/2003",70,0,70,0
"9826","9/24/2004",54,2,52,3.84615384615385
"9827","9/24/2005",46,3,43,6.97674418604651
"9828","9/24/2006",123,5,118,4.23728813559322
"9829","9/24/2007",76,0,76,0
"9830","9/24/2008",71,4,67,5.97014925373134
"9831","9/24/2009",60,3,57,5.26315789473684
"9832","9/24/2010",52,3,49,6.12244897959184
"9833","9/24/2011",65,7,58,12.0689655172414
"9834","9/24/2012",74,0,74,0
"9835","9/24/2013",69,1,68,1.47058823529412
"9836","9/24/2014",69,2,67,2.98507462686567
"9837","9/24/2015",70,6,64,9.375
"9838","9/24/2016",66,3,63,4.76190476190476
"9839","9/24/2017",128,8,120,6.66666666666667
"9840","9/24/2018",73,0,73,0
"9841","9/24/2019",66,0,66,0
"9842","9/24/2020",71,4,67,5.97014925373134
"9843","9/24/2021",62,4,58,6.89655172413793
"9844","9/25/1994",154,3,151,1.98675496688742
"9845","9/25/1995",73,0,73,0
"9846","9/25/1996",73,0,73,0
"9847","9/25/1997",64,1,63,1.58730158730159
"9848","9/25/1998",62,6,56,10.7142857142857
"9849","9/25/1999",61,1,60,1.66666666666667
"9850","9/25/2000",71,0,71,0
"9851","9/25/2001",72,2,70,2.85714285714286
"9852","9/25/2002",72,0,72,0
"9853","9/25/2003",71,2,69,2.89855072463768
"9854","9/25/2004",49,0,49,0
"9855","9/25/2005",123,4,119,3.36134453781513
"9856","9/25/2006",74,1,73,1.36986301369863
"9857","9/25/2007",75,5,70,7.14285714285714
"9858","9/25/2008",72,3,69,4.34782608695652
"9859","9/25/2009",68,1,67,1.49253731343284
"9860","9/25/2010",56,3,53,5.66037735849057
"9861","9/25/2011",118,2,116,1.72413793103448
"9862","9/25/2012",72,1,71,1.40845070422535
"9863","9/25/2013",72,2,70,2.85714285714286
"9864","9/25/2014",70,5,65,7.69230769230769
"9865","9/25/2015",59,2,57,3.50877192982456
"9866","9/25/2016",129,4,125,3.2
"9867","9/25/2017",72,1,71,1.40845070422535
"9868","9/25/2018",71,1,70,1.42857142857143
"9869","9/25/2019",63,0,63,0
"9870","9/25/2020",66,3,63,4.76190476190476
"9871","9/25/2021",59,3,56,5.35714285714286
"9872","9/26/1994",73,1,72,1.38888888888889
"9873","9/26/1995",71,4,67,5.97014925373134
"9874","9/26/1996",64,0,64,0
"9875","9/26/1997",64,2,62,3.2258064516129
"9876","9/26/1998",57,5,52,9.61538461538462
"9877","9/26/1999",149,2,147,1.36054421768707
"9878","9/26/2000",74,3,71,4.22535211267606
"9879","9/26/2001",74,1,73,1.36986301369863
"9880","9/26/2002",67,2,65,3.07692307692308
"9881","9/26/2003",64,2,62,3.2258064516129
"9882","9/26/2004",120,6,114,5.26315789473684
"9883","9/26/2005",68,0,68,0
"9884","9/26/2006",71,1,70,1.42857142857143
"9885","9/26/2007",73,1,72,1.38888888888889
"9886","9/26/2008",67,10,57,17.5438596491228
"9887","9/26/2009",64,6,58,10.3448275862069
"9888","9/26/2010",122,4,118,3.38983050847458
"9889","9/26/2011",73,0,73,0
"9890","9/26/2012",72,3,69,4.34782608695652
"9891","9/26/2013",66,2,64,3.125
"9892","9/26/2014",57,3,54,5.55555555555556
"9893","9/26/2015",61,7,54,12.962962962963
"9894","9/26/2016",76,2,74,2.7027027027027
"9895","9/26/2017",71,1,70,1.42857142857143
"9896","9/26/2018",70,5,65,7.69230769230769
"9897","9/26/2019",66,1,65,1.53846153846154
"9898","9/26/2020",67,4,63,6.34920634920635
"9899","9/26/2021",125,12,113,10.6194690265487
"9900","9/27/1994",64,1,63,1.58730158730159
"9901","9/27/1995",71,1,70,1.42857142857143
"9902","9/27/1996",64,1,63,1.58730158730159
"9903","9/27/1997",59,2,57,3.50877192982456
"9904","9/27/1998",131,1,130,0.769230769230769
"9905","9/27/1999",76,0,76,0
"9906","9/27/2000",75,2,73,2.73972602739726
"9907","9/27/2001",65,1,64,1.5625
"9908","9/27/2002",64,3,61,4.91803278688525
"9909","9/27/2003",64,2,62,3.2258064516129
"9910","9/27/2004",76,0,76,0
"9911","9/27/2005",66,2,64,3.125
"9912","9/27/2006",71,2,69,2.89855072463768
"9913","9/27/2007",70,0,70,0
"9914","9/27/2008",64,6,58,10.3448275862069
"9915","9/27/2009",116,4,112,3.57142857142857
"9916","9/27/2010",72,0,72,0
"9917","9/27/2011",70,2,68,2.94117647058824
"9918","9/27/2012",64,3,61,4.91803278688525
"9919","9/27/2013",66,5,61,8.19672131147541
"9920","9/27/2014",63,9,54,16.6666666666667
"9921","9/27/2015",113,7,106,6.60377358490566
"9922","9/27/2016",74,2,72,2.77777777777778
"9923","9/27/2017",74,2,72,2.77777777777778
"9924","9/27/2018",76,5,71,7.04225352112676
"9925","9/27/2019",57,0,57,0
"9926","9/27/2020",122,5,117,4.27350427350427
"9927","9/27/2021",74,3,71,4.22535211267606
"9928","9/28/1994",77,0,77,0
"9929","9/28/1995",64,0,64,0
"9930","9/28/1996",65,2,63,3.17460317460317
"9931","9/28/1997",127,1,126,0.793650793650794
"9932","9/28/1998",75,2,73,2.73972602739726
"9933","9/28/1999",75,0,75,0
"9934","9/28/2000",73,3,70,4.28571428571429
"9935","9/28/2001",60,1,59,1.69491525423729
"9936","9/28/2002",71,1,70,1.42857142857143
"9937","9/28/2003",129,0,129,0
"9938","9/28/2004",75,1,74,1.35135135135135
"9939","9/28/2005",73,2,71,2.8169014084507
"9940","9/28/2006",68,2,66,3.03030303030303
"9941","9/28/2007",65,6,59,10.1694915254237
"9942","9/28/2008",127,1,126,0.793650793650794
"9943","9/28/2009",75,1,74,1.35135135135135
"9944","9/28/2010",71,1,70,1.42857142857143
"9945","9/28/2011",68,2,66,3.03030303030303
"9946","9/28/2012",60,7,53,13.2075471698113
"9947","9/28/2013",50,6,44,13.6363636363636
"9948","9/28/2014",125,5,120,4.16666666666667
"9949","9/28/2015",73,2,71,2.8169014084507
"9950","9/28/2016",68,3,65,4.61538461538462
"9951","9/28/2017",64,0,64,0
"9952","9/28/2018",59,1,58,1.72413793103448
"9953","9/28/2019",51,2,49,4.08163265306122
"9954","9/28/2020",77,4,73,5.47945205479452
"9955","9/28/2021",72,3,69,4.34782608695652
"9956","9/29/1994",72,2,70,2.85714285714286
"9957","9/29/1995",59,2,57,3.50877192982456
"9958","9/29/1996",120,4,116,3.44827586206897
"9959","9/29/1997",70,0,70,0
"9960","9/29/1998",69,0,69,0
"9961","9/29/1999",64,1,63,1.58730158730159
"9962","9/29/2000",62,4,58,6.89655172413793
"9963","9/29/2001",65,1,64,1.5625
"9964","9/29/2002",124,2,122,1.63934426229508
"9965","9/29/2003",75,0,75,0
"9966","9/29/2004",73,1,72,1.38888888888889
"9967","9/29/2005",65,1,64,1.5625
"9968","9/29/2006",62,2,60,3.33333333333333
"9969","9/29/2007",64,2,62,3.2258064516129
"9970","9/29/2008",72,1,71,1.40845070422535
"9971","9/29/2009",73,1,72,1.38888888888889
"9972","9/29/2010",75,1,74,1.35135135135135
"9973","9/29/2011",70,2,68,2.94117647058824
"9974","9/29/2012",58,3,55,5.45454545454545
"9975","9/29/2013",125,2,123,1.6260162601626
"9976","9/29/2014",76,2,74,2.7027027027027
"9977","9/29/2015",75,2,73,2.73972602739726
"9978","9/29/2016",73,5,68,7.35294117647059
"9979","9/29/2017",64,4,60,6.66666666666667
"9980","9/29/2018",60,5,55,9.09090909090909
"9981","9/29/2019",129,8,121,6.61157024793388
"9982","9/29/2020",75,3,72,4.16666666666667
"9983","9/29/2021",71,2,69,2.89855072463768
"9984","9/3/1994",59,0,59,0
"9985","9/3/1995",122,0,122,0
"9986","9/3/1996",76,1,75,1.33333333333333
"9987","9/3/1997",72,0,72,0
"9988","9/3/1998",67,3,64,4.6875
"9989","9/3/1999",61,1,60,1.66666666666667
"9990","9/3/2000",120,6,114,5.26315789473684
"9991","9/3/2001",76,1,75,1.33333333333333
"9992","9/3/2002",74,0,74,0
"9993","9/3/2003",74,1,73,1.36986301369863
"9994","9/3/2004",70,6,64,9.375
"9995","9/3/2005",59,1,58,1.72413793103448
"9996","9/3/2006",127,7,120,5.83333333333333
"9997","9/3/2007",71,0,71,0
"9998","9/3/2008",67,4,63,6.34920634920635
"9999","9/3/2009",70,0,70,0
"10000","9/3/2010",62,2,60,3.33333333333333
"10001","9/3/2011",62,4,58,6.89655172413793
"10002","9/3/2012",73,0,73,0
"10003","9/3/2013",71,1,70,1.42857142857143
"10004","9/3/2014",71,4,67,5.97014925373134
"10005","9/3/2015",89,8,81,9.87654320987654
"10006","9/3/2016",61,6,55,10.9090909090909
"10007","9/3/2017",119,12,107,11.214953271028
"10008","9/3/2018",76,0,76,0
"10009","9/3/2019",70,1,69,1.44927536231884
"10010","9/3/2020",68,5,63,7.93650793650794
"10011","9/3/2021",61,3,58,5.17241379310345
"10012","9/30/1994",58,0,58,0
"10013","9/30/1995",64,1,63,1.58730158730159
"10014","9/30/1996",72,0,72,0
"10015","9/30/1997",75,0,75,0
"10016","9/30/1998",74,5,69,7.2463768115942
"10017","9/30/1999",65,2,63,3.17460317460317
"10018","9/30/2000",61,11,50,22
"10019","9/30/2001",131,3,128,2.34375
"10020","9/30/2002",75,0,75,0
"10021","9/30/2003",68,0,68,0
"10022","9/30/2004",72,1,71,1.40845070422535
"10023","9/30/2005",61,0,61,0
"10024","9/30/2006",56,2,54,3.7037037037037
"10025","9/30/2007",128,5,123,4.0650406504065
"10026","9/30/2008",78,2,76,2.63157894736842
"10027","9/30/2009",77,2,75,2.66666666666667
"10028","9/30/2010",73,0,73,0
"10029","9/30/2011",54,2,52,3.84615384615385
"10030","9/30/2012",129,5,124,4.03225806451613
"10031","9/30/2013",70,0,70,0
"10032","9/30/2014",68,2,66,3.03030303030303
"10033","9/30/2015",71,1,70,1.42857142857143
"10034","9/30/2016",63,7,56,12.5
"10035","9/30/2017",64,8,56,14.2857142857143
"10036","9/30/2018",126,5,121,4.13223140495868
"10037","9/30/2019",77,4,73,5.47945205479452
"10038","9/30/2020",72,2,70,2.85714285714286
"10039","9/30/2021",66,3,63,4.76190476190476
"10040","9/4/1994",118,0,118,0
"10041","9/4/1995",67,0,67,0
"10042","9/4/1996",72,1,71,1.40845070422535
"10043","9/4/1997",72,2,70,2.85714285714286
"10044","9/4/1998",63,1,62,1.61290322580645
"10045","9/4/1999",58,4,54,7.40740740740741
"10046","9/4/2000",68,1,67,1.49253731343284
"10047","9/4/2001",73,0,73,0
"10048","9/4/2002",69,1,68,1.47058823529412
"10049","9/4/2003",70,0,70,0
"10050","9/4/2004",51,2,49,4.08163265306122
"10051","9/4/2005",131,4,127,3.1496062992126
"10052","9/4/2006",67,0,67,0
"10053","9/4/2007",74,3,71,4.22535211267606
"10054","9/4/2008",71,0,71,0
"10055","9/4/2009",59,4,55,7.27272727272727
"10056","9/4/2010",56,5,51,9.80392156862745
"10057","9/4/2011",120,6,114,5.26315789473684
"10058","9/4/2012",69,1,68,1.47058823529412
"10059","9/4/2013",70,2,68,2.94117647058824
"10060","9/4/2014",75,2,73,2.73972602739726
"10061","9/4/2015",66,4,62,6.45161290322581
"10062","9/4/2016",123,3,120,2.5
"10063","9/4/2017",69,1,68,1.47058823529412
"10064","9/4/2018",74,2,72,2.77777777777778
"10065","9/4/2019",76,3,73,4.10958904109589
"10066","9/4/2020",67,4,63,6.34920634920635
"10067","9/4/2021",53,2,51,3.92156862745098
"10068","9/5/1994",70,1,69,1.44927536231884
"10069","9/5/1995",73,1,72,1.38888888888889
"10070","9/5/1996",67,2,65,3.07692307692308
"10071","9/5/1997",68,3,65,4.61538461538462
"10072","9/5/1998",66,2,64,3.125
"10073","9/5/1999",130,13,117,11.1111111111111
"10074","9/5/2000",76,1,75,1.33333333333333
"10075","9/5/2001",71,5,66,7.57575757575758
"10076","9/5/2002",66,3,63,4.76190476190476
"10077","9/5/2003",62,3,59,5.08474576271187
"10078","9/5/2004",126,1,125,0.8
"10079","9/5/2005",75,0,75,0
"10080","9/5/2006",75,1,74,1.35135135135135
"10081","9/5/2007",78,3,75,4
"10082","9/5/2008",64,6,58,10.3448275862069
"10083","9/5/2009",60,4,56,7.14285714285714
"10084","9/5/2010",124,5,119,4.20168067226891
"10085","9/5/2011",73,1,72,1.38888888888889
"10086","9/5/2012",71,3,68,4.41176470588235
"10087","9/5/2013",73,5,68,7.35294117647059
"10088","9/5/2014",56,2,54,3.7037037037037
"10089","9/5/2015",53,3,50,6
"10090","9/5/2016",73,0,73,0
"10091","9/5/2017",69,0,69,0
"10092","9/5/2018",70,0,70,0
"10093","9/5/2019",75,0,75,0
"10094","9/5/2020",57,4,53,7.54716981132075
"10095","9/5/2021",127,6,121,4.95867768595041
"10096","9/6/1994",70,1,69,1.44927536231884
"10097","9/6/1995",68,0,68,0
"10098","9/6/1996",61,0,61,0
"10099","9/6/1997",54,1,53,1.88679245283019
"10100","9/6/1998",149,5,144,3.47222222222222
"10101","9/6/1999",71,1,70,1.42857142857143
"10102","9/6/2000",70,1,69,1.44927536231884
"10103","9/6/2001",64,2,62,3.2258064516129
"10104","9/6/2002",58,3,55,5.45454545454545
"10105","9/6/2003",60,2,58,3.44827586206897
"10106","9/6/2004",67,0,67,0
"10107","9/6/2005",74,2,72,2.77777777777778
"10108","9/6/2006",69,0,69,0
"10109","9/6/2007",64,1,63,1.58730158730159
"10110","9/6/2008",63,4,59,6.77966101694915
"10111","9/6/2009",120,7,113,6.19469026548673
"10112","9/6/2010",71,0,71,0
"10113","9/6/2011",73,0,73,0
"10114","9/6/2012",77,3,74,4.05405405405405
"10115","9/6/2013",62,1,61,1.63934426229508
"10116","9/6/2014",62,5,57,8.7719298245614
"10117","9/6/2015",121,4,117,3.41880341880342
"10118","9/6/2016",73,1,72,1.38888888888889
"10119","9/6/2017",72,2,70,2.85714285714286
"10120","9/6/2018",72,3,69,4.34782608695652
"10121","9/6/2019",63,2,61,3.27868852459016
"10122","9/6/2020",135,4,131,3.05343511450382
"10123","9/6/2021",69,0,69,0
"10124","9/7/1994",68,2,66,3.03030303030303
"10125","9/7/1995",72,0,72,0
"10126","9/7/1996",63,1,62,1.61290322580645
"10127","9/7/1997",124,2,122,1.63934426229508
"10128","9/7/1998",76,0,76,0
"10129","9/7/1999",70,2,68,2.94117647058824
"10130","9/7/2000",63,2,61,3.27868852459016
"10131","9/7/2001",59,2,57,3.50877192982456
"10132","9/7/2002",52,2,50,4
"10133","9/7/2003",131,7,124,5.64516129032258
"10134","9/7/2004",76,2,74,2.7027027027027
"10135","9/7/2005",71,0,71,0
"10136","9/7/2006",71,1,70,1.42857142857143
"10137","9/7/2007",64,4,60,6.66666666666667
"10138","9/7/2008",125,1,124,0.806451612903226
"10139","9/7/2009",74,0,74,0
"10140","9/7/2010",72,2,70,2.85714285714286
"10141","9/7/2011",72,0,72,0
"10142","9/7/2012",62,5,57,8.7719298245614
"10143","9/7/2013",56,2,54,3.7037037037037
"10144","9/7/2014",129,6,123,4.8780487804878
"10145","9/7/2015",75,3,72,4.16666666666667
"10146","9/7/2016",71,0,71,0
"10147","9/7/2017",70,4,66,6.06060606060606
"10148","9/7/2018",61,2,59,3.38983050847458
"10149","9/7/2019",63,2,61,3.27868852459016
"10150","9/7/2020",74,0,74,0
"10151","9/7/2021",71,2,69,2.89855072463768
"10152","9/8/1994",69,0,69,0
"10153","9/8/1995",69,1,68,1.47058823529412
"10154","9/8/1996",115,1,114,0.87719298245614
"10155","9/8/1997",79,0,79,0
"10156","9/8/1998",72,4,68,5.88235294117647
"10157","9/8/1999",69,0,69,0
"10158","9/8/2000",67,3,64,4.6875
"10159","9/8/2001",63,1,62,1.61290322580645
"10160","9/8/2002",127,4,123,3.2520325203252
"10161","9/8/2003",74,1,73,1.36986301369863
"10162","9/8/2004",70,2,68,2.94117647058824
"10163","9/8/2005",69,0,69,0
"10164","9/8/2006",64,3,61,4.91803278688525
"10165","9/8/2007",60,2,58,3.44827586206897
"10166","9/8/2008",76,1,75,1.33333333333333
"10167","9/8/2009",75,1,74,1.35135135135135
"10168","9/8/2010",74,1,73,1.36986301369863
"10169","9/8/2011",61,2,59,3.38983050847458
"10170","9/8/2012",56,5,51,9.80392156862745
"10171","9/8/2013",133,7,126,5.55555555555556
"10172","9/8/2014",75,0,75,0
"10173","9/8/2015",74,2,72,2.77777777777778
"10174","9/8/2016",71,5,66,7.57575757575758
"10175","9/8/2017",59,4,55,7.27272727272727
"10176","9/8/2018",64,2,62,3.2258064516129
"10177","9/8/2019",126,9,117,7.69230769230769
"10178","9/8/2020",73,0,73,0
"10179","9/8/2021",76,8,68,11.7647058823529
"10180","9/9/1994",63,6,57,10.5263157894737
"10181","9/9/1995",67,0,67,0
"10182","9/9/1996",76,0,76,0
"10183","9/9/1997",76,0,76,0
"10184","9/9/1998",74,3,71,4.22535211267606
"10185","9/9/1999",66,0,66,0
"10186","9/9/2000",66,7,59,11.864406779661
"10187","9/9/2001",128,4,124,3.2258064516129
"10188","9/9/2002",74,1,73,1.36986301369863
"10189","9/9/2003",78,5,73,6.84931506849315
"10190","9/9/2004",72,2,70,2.85714285714286
"10191","9/9/2005",64,8,56,14.2857142857143
"10192","9/9/2006",60,5,55,9.09090909090909
"10193","9/9/2007",128,4,124,3.2258064516129
"10194","9/9/2008",75,4,71,5.63380281690141
"10195","9/9/2009",71,0,71,0
"10196","9/9/2010",68,3,65,4.61538461538462
"10197","9/9/2011",61,3,58,5.17241379310345
"10198","9/9/2012",125,5,120,4.16666666666667
"10199","9/9/2013",73,1,72,1.38888888888889
"10200","9/9/2014",75,0,75,0
"10201","9/9/2015",62,1,61,1.63934426229508
"10202","9/9/2016",61,5,56,8.92857142857143
"10203","9/9/2017",64,1,63,1.58730158730159
"10204","9/9/2018",129,3,126,2.38095238095238
"10205","9/9/2019",73,2,71,2.8169014084507
"10206","9/9/2020",72,2,70,2.85714285714286
"10207","9/9/2021",61,3,58,5.17241379310345
